# Open Chinese Convert (OpenCC) Dictionary (Third-party)
# File: STCharacters.txt
# Format: key	value(s) (values separated by spaces)
# Contributors: TerryTian-tech
# License: Apache License 2.0
# Source: https://github.com/TerryTian-tech/OpenCC-Traditional-Chinese-characters-according-to-Chinese-government-standards
# Description: Convert Simplified Chinese to Traditional Chinese(The Chinese Government Standard), based on Open Chinese Convert Dictionary(https://github.com/BYVoid/OpenCC/blob/master/data/dictionary/STCharacters.txt).
# Examples : 启 → 啓; 绿 → 緑
# Reference: 《通用规范汉字表》(2013)
# Used in configs: s2t.json

锕	錒
嗳	噯
锿	鎄
皑	皚
蔼	藹
霭	靄
爱	愛
嫒	嬡
碍	礙
叆	靉
暧	曖
瑷	璦
谙	諳
鹌	鵪
𩽾	鮟
铵	銨
肮	骯
鳌	鰲
袄	襖
骜	驁
鲃	䰾
钯	鈀
坝	壩 垻
罢	罷
鲅	鮁
鲌	鮊
摆	擺 襬
败	敗
颁	頒
板	板 闆
钣	鈑
办	辦
绊	絆
帮	幫
绑	綁
谤	謗
镑	鎊
龅	齙
宝	寶
饱	飽
鸨	鴇
报	報
鲍	鮑
鹎	鵯
贝	貝
𬇙	浿
狈	狽
备	備
钡	鋇
惫	憊
辈	輩
呗	唄
贲	賁
锛	錛
绷	綳
镚	鏰
鲾	鰏
笔	筆
币	幣
毕	畢
闭	閉
诐	詖
哔	嗶
荜	蓽
毙	斃
铋	鉍
筚	篳
赑	贔
滗	潷
跸	蹕
边	邊
笾	籩
编	編
鳊	鯿
贬	貶
变	變
缏	緶
辩	辯
辫	辮
标	標
飑	颮
骉	驫
骠	驃
镖	鏢
飙	飆
镳	鑣
表	表 錶
鳔	鰾
鳖	鱉
别	别 彆
瘪	癟
宾	賓
傧	儐
滨	濱
缤	繽
槟	檳
瑸	璸
镔	鑌
濒	瀕
摈	擯
殡	殯
膑	臏
髌	髕
鬓	鬢
饼	餅
拨	撥
钵	鉢
饽	餑
𬭛	𨨏
驳	駁
袯	襏
钹	鈸
铂	鉑
鹁	鵓
馎	餺
镈	鎛
卜	卜 蔔
补	補
𬷕	鵏
钚	鈈
才	才 纔
财	財
参	參
骖	驂
残	殘
蚕	蠶
惭	慚
惨	慘
䅟	穇
黪	黲
灿	燦
掺	摻
仓	倉
伧	傖
沧	滄
苍	蒼
鸧	鶬
舱	艙
侧	側
厕	厠
恻	惻
测	測
荝	萴
层	層
馇	餷
锸	鍤
镲	鑔
诧	詫
钗	釵
侪	儕
虿	蠆
觇	覘
搀	攙
婵	嬋
谗	讒
禅	禪
馋	饞
缠	纏
蝉	蟬
镡	鐔
镵	鑱
产	産
刬	剗
浐	滻
谄	諂
啴	嘽
铲	鏟
阐	闡
𬊤	燀
蒇	蕆
骣	驏
冁	囅
忏	懺
颤	顫
伥	倀
阊	閶
锠	錩
鲳	鯧
肠	腸
苌	萇
尝	嘗
偿	償
鲿	鱨
厂	廠 厂
场	場
𬬮	鋹
怅	悵
玚	瑒
畅	暢
钞	鈔
鼌	鼂
车	車
伡	俥
砗	硨
彻	徹
𬘭	綝
尘	塵
陈	陳
谌	諶
碜	磣
衬	襯
龀	齔
榇	櫬
谶	讖
柽	檉
称	稱
蛏	蟶
赪	赬
枨	棖
诚	誠
铖	鋮
惩	懲
骋	騁
彨	彲
𫄨	絺
鸱	鴟
驰	馳
迟	遲
齿	齒
饬	飭
炽	熾
冲	衝 冲
虫	蟲
宠	寵
铳	銃
俦	儔
帱	幬
绸	綢
畴	疇
筹	籌
踌	躊
雠	讎
丑	醜 丑
出	出 齣
䝙	貙
刍	芻
锄	鋤
雏	雛
础	礎
储	儲
𬺓	齼
处	處
绌	絀
触	觸
传	傳
钏	釧
疮	瘡
闯	闖
创	創
怆	愴
锤	錘
䲠	鰆
纯	純
莼	蒓
𬭚	錞
鹑	鶉
绰	綽
辍	輟
龊	齪
词	詞
辞	辭
鹚	鷀
𫚖	鮆
刾	㓨
赐	賜
苁	蓯
枞	樅
骢	驄
聪	聰
从	從
丛	叢
辏	輳
撺	攛
镩	鑹
蹿	躥
窜	竄
缞	縗
鹾	鹺
酂	酇
锉	銼
错	錯
𨱏	鎝
达	達
哒	噠
荙	薘
𫟼	鐽
跶	躂
阘	闒
鞑	韃
垯	墶
轪	軑
绐	紿
骀	駘
带	帶
贷	貸
叇	靆
单	單
担	擔
郸	鄲
殚	殫
瘅	癉
箪	簞
𬘘	紞
胆	膽
掸	撣
赕	賧
诞	誕
𫢸	僤
弹	彈
惮	憚
当	當 噹
珰	璫
裆	襠
铛	鐺
筜	簹
挡	擋
党	黨 党
谠	讜
𣗋	欓
砀	碭
垱	壋
荡	蕩
档	檔
𬍡	璗
鱽	魛
导	導
岛	島
陦	隯
捣	搗
祷	禱
焘	燾
锝	鍀
灯	燈
邓	鄧
镫	鐙
䃅	磾
镝	鏑
籴	糴
敌	敵
涤	滌
𬱖	頔
觌	覿
诋	詆
递	遞
谛	諦
缔	締
䗖	螮
颠	顛
巅	巔
癫	癲
点	點
电	電
垫	墊
钿	鈿
淀	澱 淀
鲷	鯛
钓	釣
窎	窵
调	調
铞	銱
铫	銚
绖	絰
谍	諜
𫶇	嵽
鲽	鰈
钉	釘
顶	頂
订	訂
饤	飣
铤	鋌
锭	錠
铥	銩
东	東
冬	冬 鼕
岽	崬
鸫	鶇
𬟽	蝀
动	動
冻	凍
栋	棟
胨	腖
斗	鬥 斗
饾	餖
窦	竇
阇	闍
独	獨
读	讀
渎	瀆
椟	櫝
牍	牘
犊	犢
黩	黷
笃	篤
赌	賭
𬭊	𨧀
镀	鍍
断	斷
缎	緞
锻	鍛
簖	籪
队	隊
对	對
怼	懟
镦	鐓
吨	噸
趸	躉
钝	鈍
顿	頓
夺	奪
铎	鐸
缍	綞
亸	嚲
饳	飿
堕	墮
讹	訛
锇	鋨
鹅	鵝
额	額
轭	軛
垩	堊
恶	惡 噁
饿	餓
谔	諤
阏	閼
𫫇	噁
锷	鍔
鹗	鶚
颚	顎
鳄	鰐
诶	誒
儿	兒
鸸	鴯
鲕	鮞
尔	爾
迩	邇
饵	餌
铒	鉺
贰	貳
发	發 髮
罚	罰
阀	閥
矾	礬
钒	釩
烦	煩
𫔍	鐇
𬸪	鷭
饭	飯
范	範 范
贩	販
钫	鈁
鲂	魴
访	訪
纺	紡
飞	飛
绯	緋
𬴂	騑
鲱	鯡
诽	誹
废	廢
费	費
镄	鐨
纷	紛
坟	墳
𣸣	濆
豮	豶
奋	奮
偾	僨
愤	憤
粪	糞
鲼	鱝
丰	豐 丰
风	風
沣	灃
沨	渢
枫	楓
疯	瘋
砜	碸
锋	鋒
冯	馮
讽	諷
凤	鳳
缝	縫
赗	賵
夫	夫 伕
肤	膚
𫓧	鈇
麸	麩
凫	鳬
绂	紱
绋	紼
韨	韍
辐	輻
呒	嘸
抚	撫
辅	輔
𫖯	頫
讣	訃
妇	婦
负	負
驸	駙
复	復 複 覆
赋	賦
缚	縛
鲋	鮒
赙	賻
鳆	鰒
钆	釓
该	該
赅	賅
钙	鈣
𬮿	隑
盖	蓋
尴	尷
赶	趕
鳡	鱤
干	幹 乾 干
绀	紺
赣	贛
冈	岡
刚	剛
纲	綱
㭎	棡
钢	鋼
岗	崗
戆	戇
缟	縞
镐	鎬
诰	誥
锆	鋯
纥	紇
鸽	鴿
搁	擱
阁	閣
镉	鎘
个	個 箇
铬	鉻
给	給
赓	賡
鹒	鶊
绠	綆
鲠	鯁
龚	龔
巩	鞏
贡	貢
唝	嗊
沟	溝
钩	鈎
缑	緱
构	構
诟	詬
购	購
觏	覯
轱	軲
鸪	鴣
诂	詁
谷	谷 穀
钴	鈷
蛊	蠱
馉	餶
鹄	鵠
毂	轂
鹘	鶻
顾	顧
锢	錮
鲴	鯝
刮	刮 颳
鸹	鴰
剐	剮
诖	詿
掴	摑
关	關
观	觀
鳏	鰥
馆	館
鳤	䲘
贯	貫
惯	慣
掼	摜
鹳	鸛
𨐈	輄
广	廣 广
犷	獷
归	歸
妫	嬀
龟	龜
规	規
闺	閨
椝	規
鲑	鮭
鬶	鬹
轨	軌
匦	匭
诡	詭
刽	劊
刿	劌
柜	櫃 柜
贵	貴
桧	檜
椢	槶
鳜	鱖
绲	緄
辊	輥
鲧	鯀
呙	咼
埚	堝
啯	嘓
锅	鍋
蝈	蟈
国	國
帼	幗
𬇹	漍
腘	膕
馃	餜
过	過
铪	鉿
还	還
骇	駭
顸	頇
韩	韓
阚	闞
㘎	㘚
汉	漢
闬	閈
颔	頷
绗	絎
颃	頏
号	號
颢	顥
灏	灝
诃	訶
合	合 閤
阂	閡
饸	餄
龁	齕
颌	頜
阖	闔
鲄	魺
鹖	鶡
贺	賀
鹤	鶴
𬭶	𨭆
𬣳	詪
鸻	鴴
轰	轟
红	紅
纮	紘
闳	閎
荭	葒
𫟹	鉷
鸿	鴻
𬭎	鋐
黉	黌
讧	訌
𬭤	鍭
后	後 后
鲎	鱟
鲘	鮜
轷	軤
胡	胡 鬍
壶	壺
鹕	鶘
浒	滸
护	護
沪	滬
鹱	鸌
鳠	鱯
哗	嘩
华	華
骅	驊
铧	鏵
划	劃 划
画	畫
话	話
桦	樺
婳	嫿
怀	懷
坏	壞
欢	歡
环	環
𬘫	綄
锾	鍰
缳	繯
阛	闤
𤩽	瓛
镮	鐶
鹮	䴉
缓	緩
鲩	鯇
锽	鍠
𨱑	鐄
鳇	鰉
谎	謊
㧑	撝
诙	詼
挥	揮
袆	褘
晖	暉
珲	琿
翚	翬
辉	輝
回	回 迴
汇	匯 彙
会	會
讳	諱
哕	噦
浍	澮
绘	繪
荟	薈
诲	誨
烩	燴
贿	賄
秽	穢
缋	繢
翙	翽
阓	闠
颒	頮
𬤝	譓
𬭬	鏏
荤	葷
阍	閽
浑	渾
馄	餛
诨	諢
𬴃	騞
锪	鍃
伙	夥 伙
钬	鈥
货	貨
获	獲 穫
祸	禍
镬	鑊
讥	譏
击	擊
叽	嘰
饥	飢 饑
机	機
玑	璣
矶	磯
鸡	鷄
𬯀	隮
积	積
绩	績
𫓯	銈
缉	緝
赍	賫
𫌀	襀
跻	躋
𫓹	錤
齑	齏
羁	羈
级	級
极	極
诘	詰
辑	輯
鹡	鶺
几	幾 几
虮	蟣
挤	擠
鱾	魢
计	計
记	記
纪	紀
际	際
剂	劑
哜	嚌
济	濟
荠	薺
𪟝	勣
继	繼
觊	覬
蓟	薊
霁	霽
鲚	鱭
鲫	鯽
𬶨	鱀
骥	驥
𬶭	鰶
夹	夾
浃	浹
家	家 傢
𬂩	梜
镓	鎵
郏	郟
荚	莢
铗	鋏
蛱	蛺
颊	頰
贾	賈
钾	鉀
槚	檟
价	價 价
驾	駕
戋	戔
坚	堅
歼	殲
间	間
艰	艱
监	監
笺	箋
缄	緘
缣	縑
鲣	鰹
鹣	鶼
篯	籛
鞯	韉
鳒	鰜
拣	揀
枧	梘
俭	儉
茧	繭
捡	撿
笕	筧
检	檢
睑	瞼
硷	礆
裥	襇
锏	鐧
简	簡
谫	謭
见	見
𬣡	諓
饯	餞
剑	劍
荐	薦 荐
贱	賤
涧	澗
舰	艦
渐	漸
谏	諫
溅	濺
践	踐
鉴	鑒 鑑
键	鍵
姜	姜 薑
将	將
浆	漿
螀	螿
缰	繮
鳉	鱂
讲	講
奖	奬
桨	槳
蒋	蔣
绛	絳
酱	醬
娇	嬌
浇	澆
骄	驕
胶	膠
鲛	鮫
䴔	鵁
鹪	鷦
侥	僥
挢	撟
绞	絞
饺	餃
矫	矯
铰	鉸
搅	攪
缴	繳
峤	嶠
轿	轎
较	較
阶	階
疖	癤
节	節
讦	訐
洁	潔
结	結
颉	頡
鲒	鮚
诫	誡
借	借 藉
钅	釒
𬬱	釿
仅	僅
尽	盡 儘
侭	儘
紧	緊
谨	謹
锦	錦
馑	饉
劲	勁
进	進
浕	濜
荩	藎
烬	燼
赆	贐
琎	璡
缙	縉
觐	覲
泾	涇
经	經
茎	莖
惊	驚
鲸	鯨
䴖	鶄
刭	剄
颈	頸
弪	弳
径	徑
迳	逕
胫	脛
痉	痙
竞	競
靓	靚
镜	鏡
𬳶	駉
䌹	絅
颎	熲
纠	糾
鸠	鳩
阄	鬮
旧	舊
鹫	鷲
驹	駒
锔	鋦
𬶋	鮈
䴗	鶪
举	舉
榉	櫸
龃	齟
讵	詎
钜	鉅
剧	劇
惧	懼
据	據 据
飓	颶
锯	鋸
窭	窶
屦	屨
鹃	鵑
镌	鎸
卷	卷 捲
锩	錈
绢	絹
诀	訣
𫘝	駃
绝	絶
觉	覺
谲	譎
镢	鐝
𫔎	鐍
军	軍
钧	鈞
皲	皸
鲪	鮶
馂	餕
骏	駿
开	開
锎	鐦
凯	凱
剀	剴
垲	塏
恺	愷
闿	闓
铠	鎧
锴	鍇
忾	愾
龛	龕
槛	檻
闶	閌
𩾌	鱇
钪	鈧
铐	銬
鲓	鮳
轲	軻
钶	鈳
颏	頦
颗	顆
壳	殻
克	克 剋
课	課
骒	騍
缂	緙
锞	錁
垦	墾
恳	懇
龈	齦
硁	硜
铿	鏗
𫸩	彄
抠	摳
眍	瞘
库	庫
绔	絝
喾	嚳
裤	褲
夸	誇 夸
㧟	擓
块	塊
侩	儈
郐	鄶
哙	噲
狯	獪
脍	膾
鲙	鱠
宽	寬
髋	髖
诓	誆
诳	誑
𫛭	鵟
邝	鄺
圹	壙
纩	纊
旷	曠
矿	礦
贶	貺
亏	虧
岿	巋
窥	窺
骙	騤
𫠆	頍
匮	匱
愦	憒
溃	潰
蒉	蕢
馈	饋
瞆	瞶
篑	簣
聩	聵
裈	褌
锟	錕
鹍	鵾
鲲	鯤
阃	閫
壸	壼
困	困 睏
扩	擴
阔	闊
腊	臘 腊
蜡	蠟 蜡
𬶟	鯻
镴	鑞
来	來
俫	倈
崃	崍
徕	徠
涞	淶
莱	萊
梾	棶
铼	錸
赉	賚
睐	睞
赖	賴
濑	瀨
癞	癩
籁	籟
兰	蘭
岚	嵐
拦	攔
栏	欄
阑	闌
蓝	藍
𬒗	𥗽
谰	讕
澜	瀾
褴	襤
斓	斕
篮	籃
襕	襴
镧	鑭
览	覽
揽	攬
缆	纜
榄	欖
懒	懶
烂	爛
滥	濫
阆	閬
锒	鋃
捞	撈
劳	勞
唠	嘮
𫭼	𡑍
崂	嶗
痨	癆
铹	鐒
铑	銠
涝	澇
耢	耮
乐	樂
鳓	鰳
了	了 瞭
饹	餎
缧	縲
镭	鐳
诔	誄
垒	壘
类	類
累	纍 累
离	離
骊	驪
鹂	鸝
漓	漓 灕
缡	縭
蓠	蘺
鲡	鱺
篱	籬
礼	禮
里	裏 里
逦	邐
锂	鋰
鲤	鯉
鳢	鱧
历	歷 曆
厉	厲
丽	麗
励	勵
呖	嚦
坜	壢
𫵷	㠣
沥	瀝
苈	藶
枥	櫪
疠	癘
隶	隸
俪	儷
栎	櫟
𬍛	瓅
疬	癧
轹	轢
郦	酈
砺	礪
砾	礫
粝	糲
蛎	蠣
跞	躒
雳	靂
俩	倆
奁	奩
连	連
帘	簾 帘
怜	憐
涟	漣
莲	蓮
梿	槤
联	聯
裢	褳
鲢	鰱
镰	鐮
敛	斂
琏	璉
脸	臉
裣	襝
蔹	蘞
练	練
炼	煉
恋	戀
殓	殮
链	鏈
潋	瀲
𬶠	鰊
𫟅	綡
辌	輬
粮	糧
两	兩
唡	啢
𬜯	䓣
魉	魎
谅	諒
辆	輛
辽	遼
疗	療
缭	繚
鹩	鷯
钌	釕
镣	鐐
猎	獵
䴕	鴷
𫚭	鱲
邻	鄰
临	臨
𬴊	驎
辚	轔
𬭸	鏻
鳞	鱗
赁	賃
蔺	藺
躏	躪
灵	靈
铃	鈴
鸰	鴒
棂	欞
绫	綾
龄	齡
鲮	鯪
岭	嶺
领	領
刘	劉
浏	瀏
馏	餾
骝	騮
飗	飀
镏	鎦
鹠	鶹
镠	鏐
绺	綹
锍	鋶
鹨	鷚
龙	龍
咙	嚨
泷	瀧
茏	蘢
昽	曨
栊	櫳
珑	瓏
胧	朧
眬	矓
砻	礱
笼	籠
聋	聾
陇	隴
垄	壟
拢	攏
𬕂	篢
䁖	瞜
娄	婁
偻	僂
喽	嘍
𪣻	塿
溇	漊
蒌	蔞
楼	樓
耧	耬
蝼	螻
髅	髏
嵝	嶁
搂	摟
篓	簍
瘘	瘻
镂	鏤
噜	嚕
撸	擼
卢	盧
庐	廬
芦	蘆
垆	壚
泸	瀘
炉	爐
栌	櫨
胪	臚
轳	轤
𬬻	鑪
鸬	鸕
舻	艫
颅	顱
鲈	鱸
卤	滷 鹵
虏	虜
掳	擄
硵	磠
鲁	魯
澛	瀂
橹	櫓
镥	鑥
陆	陸
录	録
赂	賂
辂	輅
𫘧	騄
箓	籙
辘	轆
鹭	鷺
氇	氌
驴	驢
闾	閭
榈	櫚
𦝼	膢
铝	鋁
屡	屢
缕	縷
褛	褸
穞	穭
虑	慮
绿	緑
滤	濾
娈	孌
孪	孿
峦	巒
挛	攣
栾	欒
鸾	鸞
脔	臠
滦	灤
銮	鑾
乱	亂
锊	鋝
抡	掄
仑	侖
伦	倫
囵	圇
沦	淪
纶	綸
轮	輪
𬬭	錀
𫭢	埨
论	論
罗	羅
啰	囉
猡	玀
脶	腡
萝	蘿
逻	邏
椤	欏
锣	鑼
箩	籮
骡	騾
镙	鏍
泺	濼
络	絡
荦	犖
骆	駱
妈	媽
马	馬
玛	瑪
码	碼
蚂	螞
犸	獁
杩	榪
祃	禡
骂	駡
唛	嘜
吗	嗎
买	買
荬	蕒
劢	勱
迈	邁
麦	麥
卖	賣
鿏	䥑
颟	顢
蛮	蠻
谩	謾
馒	饅
瞒	瞞
蹒	蹣
鳗	鰻
满	滿
螨	蟎
𬜬	蔄
缦	縵
镘	鏝
锚	錨
铆	鉚
贸	貿
么	麽
镅	鎇
鹛	鶥
霉	黴
镁	鎂
门	門
扪	捫
钔	鍆
𫞩	璊
闷	悶
焖	燜
懑	懣
们	們
𫑡	鄳
蒙	蒙 矇 濛 懞
鹲	鸏
锰	錳
梦	夢
弥	彌 瀰
祢	禰
猕	獼
谜	謎
觅	覓
谧	謐
绵	綿
黾	黽
渑	澠
缅	緬
𩾃	鮸
面	面 麵
麺	麵
鹋	鶓
缈	緲
庙	廟
灭	滅
蔑	蔑 衊
缗	緡
闵	閔
闽	閩
悯	憫
鳘	鰵
鸣	鳴
铭	銘
谬	謬
谟	謨
馍	饃
蓦	驀
镆	鏌
𬙊	纆
谋	謀
缪	繆
亩	畝
𬭁	鉧
钼	鉬
镎	鎿
纳	納
钠	鈉
难	難
馕	饢
挠	撓
铙	鐃
蛲	蟯
恼	惱
脑	腦
闹	鬧
讷	訥
馁	餒
铌	鈮
𫐐	輗
鲵	鯢
𫠜	齯
拟	擬
腻	膩
鲇	鮎
辇	輦
辗	輾
撵	攆
酿	釀
鸟	鳥
茑	蔦
袅	裊
聂	聶
啮	嚙
嗫	囁
𫔶	闑
镊	鑷
镍	鎳
颞	顳
蹑	躡
宁	寧
咛	嚀
拧	擰
狞	獰
苧	苧 薴
柠	檸
聍	聹
泞	濘
纽	紐
钮	鈕
农	農
侬	儂
哝	噥
浓	濃
脓	膿
秾	穠
𬪩	醲
驽	駑
钕	釹
疟	瘧
傩	儺
诺	諾
锘	鍩
讴	謳
𫭟	塸
沤	漚
欧	歐
殴	毆
瓯	甌
鸥	鷗
呕	嘔
𬉼	熰
怄	慪
盘	盤
厐	龐
庞	龐
鳑	鰟
拋	抛
赔	賠
锫	錇
辔	轡
喷	噴
鹏	鵬
纰	紕
𬳵	駓
铍	鈹
鲏	鮍
罴	羆
辟	闢 辟
䴙	鸊
骈	駢
谝	諞
骗	騙
缥	縹
飘	飄
𬭯	䥕
贫	貧
嫔	嬪
频	頻
𬞟	蘋
颦	顰
评	評
凭	憑
苹	蘋
鲆	鮃
钋	釙
泼	潑
䥽	鏺
钷	鉕
颇	頗
酦	醱
仆	僕 仆
扑	撲
镤	鏷
朴	樸 朴
谱	譜
镨	鐠
铺	鋪
桤	榿
齐	齊
𬨂	軝
脐	臍
颀	頎
骐	騏
骑	騎
蛴	蠐
锜	錡
蕲	蘄
鲯	鯕
鳍	鰭
岂	豈
启	啓
绮	綺
气	氣
讫	訖
碛	磧
千	千 韆
迁	遷
佥	僉
钎	釺
牵	牽
悭	慳
铅	鉛
谦	謙
签	籤 簽
骞	騫
鹐	鵮
钤	鈐
钱	錢
钳	鉗
浅	淺
谴	譴
缱	繾
堑	塹
𬘬	綪
椠	槧
呛	嗆
戗	戧
枪	槍
玱	瑲
跄	蹌
锖	錆
锵	鏘
镪	鏹
墙	墻
嫱	嬙
蔷	薔
樯	檣
抢	搶
羟	羥
炝	熗
硗	磽
跷	蹺
锹	鍬
缲	繰
乔	喬
侨	僑
荞	蕎
桥	橋
硚	礄
谯	譙
鞒	鞽
诮	誚
窍	竅
翘	翹
窃	竊
惬	愜
箧	篋
锲	鍥
亲	親
钦	欽
骎	駸
嵚	嶔
锓	鋟
寝	寢
揿	撳
氢	氫
轻	輕
倾	傾
鲭	鯖
顷	頃
请	請
庼	廎
庆	慶
穷	窮
茕	煢
䓖	藭
琼	瓊
秋	秋 鞦
鹙	鶖
鳅	鰍
赇	賕
巯	巰
𨱇	銶
区	區
曲	曲 麯
岖	嶇
诎	詘
驱	驅
躯	軀
趋	趨
麹	麴
鸲	鴝
龋	齲
阒	闃
觑	覷
权	權
诠	詮
辁	輇
铨	銓
鳈	鰁
颧	顴
绻	綣
劝	勸
阙	闕
𬒈	礐
悫	慤
确	確 确
阕	闋
鹊	鵲
让	讓
娆	嬈
荛	蕘
饶	饒
桡	橈
扰	擾
绕	繞
热	熱
认	認
讱	訒
纫	紉
纴	紝
轫	軔
韧	韌
饪	飪
驲	馹
绒	絨
荣	榮
嵘	嶸
蝾	蠑
镕	鎔
𫐓	輮
铷	銣
颥	顬
缛	縟
软	軟
锐	鋭
闰	閏
润	潤
洒	灑
钑	鈒
飒	颯
萨	薩
鳃	鰓
赛	賽
毵	毿
毶	毿
伞	傘
糁	糝
馓	饊
颡	顙
丧	喪
骚	騷
缫	繅
鳋	鰠
扫	掃
涩	澀
啬	嗇
铯	銫
穑	穡
椮	槮
杀	殺
纱	紗
铩	鎩
鲨	鯊
筛	篩
酾	釃
晒	曬
钐	釤
闪	閃
陕	陝
讪	訕
𫮃	墠
椫	樿
骟	騸
缮	繕
赡	贍
鳝	鱔
伤	傷
殇	殤
觞	觴
赏	賞
绱	緔
烧	燒
绍	紹
𪨶	輋
赊	賒
舍	舍 捨
厍	厙
设	設
慑	懾
摄	攝
滠	灄
谁	誰
绅	紳
诜	詵
𬳽	駪
鲹	鰺
𬬹	鉮
沈	沈 瀋
审	審
谂	諗
谉	讅
婶	嬸
渖	瀋
肾	腎
渗	滲
瘆	瘮
声	聲
绳	繩
圣	聖
胜	勝 胜
师	師
诗	詩
鸤	鳲
浉	溮
狮	獅
湿	濕
𫚕	鰤
䴓	鳾
鲺	鯴
饣	飠
时	時
识	識
实	實
蚀	蝕
埘	塒
莳	蒔
鲥	鰣
驶	駛
势	勢
视	視
试	試
饰	飾
贳	貰
适	適 适
轼	軾
铈	鈰
𬤊	諟
谥	謚
释	釋
寿	壽
兽	獸
绶	綬
书	書
纾	紓
枢	樞
摅	攄
输	輸
赎	贖
属	屬
术	術 术
树	樹
竖	竪
𬬸	鉥
数	數
帅	帥
闩	閂
双	雙
骦	驦
鹴	鸘
顺	順
说	説
烁	爍
铄	鑠
硕	碩
纟	糹
丝	絲
咝	噝
鸶	鷥
缌	緦
蛳	螄
飔	颸
锶	鍶
饲	飼
驷	駟
松	松 鬆
㧐	㩳
怂	慫
耸	聳
讼	訟
诵	誦
颂	頌
馊	餿
飕	颼
锼	鎪
擞	擻
薮	藪
苏	蘇 囌
稣	穌
诉	訴
肃	肅
𫗧	餗
骕	驌
谡	謖
鹔	鷫
虽	雖
绥	綏
随	隨
岁	歲
谇	誶
𫟦	䡵
𬭼	鐩
孙	孫
狲	猻
荪	蓀
损	損
缩	縮
唢	嗩
琐	瑣
锁	鎖
铊	鉈
鿎	䃮
獭	獺
鳎	鰨
挞	撻
闼	闥
台	臺 檯 颱 台
鲐	鮐
态	態
钛	鈦
贪	貪
摊	攤
滩	灘
瘫	癱
坛	壇 罎
昙	曇
谈	談
锬	錟
谭	譚
钽	鉭
叹	嘆
汤	湯
铴	鐋
镗	鏜
饧	餳
傥	儻
镋	钂
烫	燙
涛	濤
绦	縧
韬	韜
梼	檮
绹	綯
𫘦	騊
讨	討
铽	鋱
腾	騰
誊	謄
䲢	鰧
锑	銻
䴘	鷉
绨	綈
缇	緹
𫘨	騠
鹈	鵜
题	題
鳀	鯷
体	體
靔	靝
阗	闐
觍	覥
条	條
龆	齠
鲦	鰷
粜	糶
贴	貼
铁	鐵
厅	廳
听	聽
烃	烴
𬘩	綎
颋	頲
𫍣	詷
铜	銅
鲖	鮦
统	統
恸	慟
头	頭
钭	鈄
禿	秃
图	圖
涂	塗 涂
𬳿	駼
钍	釷
团	團 糰
抟	摶
𬯎	隤
颓	頽
饨	飩
鲀	魨
饦	飥
驮	馱
驼	駝
鸵	鴕
𬶍	鮀
鼍	鼉
椭	橢
萚	蘀
箨	籜
洼	窪
娲	媧
袜	襪
弯	彎
塆	壪
湾	灣
纨	紈
顽	頑
绾	綰
万	萬 万
𬇕	澫
网	網
辋	輞
鳂	鰃
韦	韋
围	圍
帏	幃
沩	潙
𣲗	湋
违	違
闱	闈
涠	潿
硙	磑
维	維
潍	濰
𬶏	鮠
伟	偉
伪	僞
纬	緯
苇	葦
𬀩	暐
炜	煒
玮	瑋
𫇭	蔿
诿	諉
𬱟	頠
韪	韙
鲔	鮪
卫	衛
为	爲
谓	謂
鳚	䲁
辒	輼
鳁	鰛
纹	紋
𫘜	馼
闻	聞
阌	閿
稳	穩
问	問
𬭩	鎓
鹟	鶲
挝	撾
涡	渦
莴	萵
窝	窩
蜗	蝸
龌	齷
乌	烏
邬	鄔
呜	嗚
诬	誣
钨	鎢
无	無
芜	蕪
铻	鋙
鹀	鵐
妩	嫵
庑	廡
怃	憮
𣲘	潕
鹉	鵡
务	務
坞	塢
误	誤
骛	騖
雾	霧
鹜	鶩
饻	餏
牺	犧
锡	錫
习	習
袭	襲
觋	覡
𫘬	騱
鳛	鰼
玺	璽
铣	銑
𬭳	𨭎
𬶮	鱚
戏	戲
屃	屓
系	系 係 繫
饩	餼
细	細
绤	綌
阋	鬩
虾	蝦
侠	俠
峡	峽
狭	狹
硖	硤
辖	轄
吓	嚇
纤	纖 縴
莶	薟
铦	銛
跹	躚
锨	鍁
鲜	鮮
𬸣	鶱
闲	閑
贤	賢
咸	鹹 咸
挦	撏
娴	嫻
衔	銜
𫍯	諴
痫	癇
鹇	鷳
狝	獮
显	顯
险	險
崄	嶮
猃	獫
蚬	蜆
藓	蘚
伣	俔
县	縣
岘	峴
苋	莧
𬀪	晛
现	現
线	綫
宪	憲
𪾢	睍
馅	餡
缐	線 綫
献	獻
乡	鄉
芗	薌
缃	緗
𬙋	纕
骧	驤
镶	鑲
详	詳
响	響
蚃	蠁
饷	餉
飨	饗
鲞	鮝
向	向 嚮
项	項
枭	梟
哓	嘵
骁	驍
绡	綃
鸮	鴞
萧	蕭
销	銷
潇	瀟
箫	簫
蟏	蠨
嚣	囂
晓	曉
𫍲	謏
啸	嘯
敩	斆
协	協
胁	脅
挟	挾
谐	諧
撷	擷
缬	纈
写	寫
泻	瀉
绁	紲
亵	褻
谢	謝
𬹼	齘
䜣	訢
𫷷	廞
锌	鋅
衅	釁
骍	騂
陉	陘
𫰛	娙
荥	滎
钘	鈃
铏	鉶
兴	興
讻	訩
诇	詗
鸺	鵂
馐	饈
绣	綉
锈	銹
𬣙	訏
吁	籲 吁
须	須 鬚
顼	頊
谞	諝
媭	嬃
𦈡	繻
许	許
诩	詡
绪	緒
续	續
轩	軒
谖	諼
𫓶	鋗
𫍽	譞
𫠊	䮄
悬	懸
旋	旋 鏇
选	選
癣	癬
绚	絢
铉	鉉
镟	鏇
学	學
峃	嶨
泶	澩
鸴	鷽
鳕	鱈
谑	謔
勋	勛
埙	塤
𫄸	纁
寻	尋
𬘓	紃
驯	馴
询	詢
浔	潯
荨	蕁
𬩽	鄩
桪	樳
𬊈	燖
𬍤	璕
鲟	鱘
训	訓
讯	訊
逊	遜
压	壓
垭	埡
鸦	鴉
桠	椏
鸭	鴨
铔	錏
哑	啞
痖	瘂
轧	軋
亚	亞
讶	訝
娅	婭
挜	掗
氩	氬
恹	懨
阉	閹
讠	訁
闫	閆
严	嚴
盐	鹽
𫄧	綖
阎	閻
颜	顔
俨	儼
䶮	龑
厣	厴
𬙂	縯
𬸘	鶠
魇	魘
𪩘	巘
黡	黶
厌	厭
觃	覎
砚	硯
艳	艷
验	驗
谚	諺
滟	灧
酽	釅
谳	讞
餍	饜
赝	贋
鸯	鴦
扬	揚
阳	陽
旸	暘
杨	楊
炀	煬
飏	颺
疡	瘍
钖	鍚
养	養
痒	癢
样	樣
尧	堯
峣	嶢
轺	軺
谣	謡
飖	颻
鳐	鰩
药	藥
钥	鑰
鹞	鷂
爷	爺
铘	鋣
业	業
叶	葉 叶
页	頁
邺	鄴
晔	曄
烨	燁
谒	謁
馌	饁
靥	靨
医	醫
祎	禕
铱	銥
鹥	鷖
仪	儀
诒	詒
饴	飴
贻	貽
遗	遺
颐	頤
钇	釔
舣	艤
蚁	蟻
𫖮	顗
𬺈	齮
义	義
亿	億
忆	憶
艺	藝
议	議
呓	囈
译	譯
峄	嶧
怿	懌
绎	繹
诣	詣
𬬩	釴
驿	驛
轶	軼
谊	誼
勚	勩
缢	縊
瘗	瘞
镒	鎰
鹝	鷊
鹢	鷁
𫄷	繶
𬟁	虉
镱	鐿
阴	陰
𬘡	絪
荫	蔭
骃	駰
𬤇	諲
铟	銦
𬮱	闉
訚	誾
银	銀
龂	齗
饮	飲
隐	隱
瘾	癮
慭	憖
䲟	鮣
应	應
莺	鶯
婴	嬰
䓨	罃
锳	鍈
嘤	嚶
撄	攖
缨	纓
罂	罌
樱	櫻
璎	瓔
鹦	鸚
鹰	鷹
茔	塋
荧	熒
莹	瑩
萤	螢
营	營
萦	縈
溁	濚
滢	瀅
蓥	鎣
潆	瀠
蝇	蠅
赢	贏
颍	潁
颕	穎
颖	穎
瘿	癭
哟	喲
佣	傭 佣
拥	擁
痈	癰
镛	鏞
鳙	鱅
颙	顒
踊	踴
鲬	鯒
优	優
忧	憂
犹	猶
邮	郵
莸	蕕
铀	鈾
鱿	魷
𬨎	輶
鲉	鮋
铕	銪
诱	誘
蒏	醟
纡	紆
余	餘 余
欤	歟
玙	璵
鱼	魚
谀	諛
馀	餘
渔	漁
觎	覦
舆	輿
与	與
伛	傴
屿	嶼
语	語
龉	齬
驭	馭
妪	嫗
饫	飫
郁	鬱 郁
狱	獄
钰	鈺
预	預
谕	諭
阈	閾
御	御 禦
鹆	鵒
滪	澦
蓣	蕷
誉	譽
鹬	鷸
鸢	鳶
鸳	鴛
渊	淵
鹓	鵷
贠	員
员	員
园	園
圆	圓
缘	緣
鼋	黿
𫘪	騵
辕	轅
橼	櫞
远	遠
愿	願 愿
约	約
彟	彠
𫐄	軏
钺	鉞
阅	閲
跃	躍
𬸚	鸑
晕	暈
缊	緼
𫖳	頵
赟	贇
云	雲 云
沄	澐
纭	紜
芸	芸 蕓
郧	鄖
涢	溳
筼	篔
陨	隕
殒	殞
运	運
郓	鄆
恽	惲
酝	醖
韫	韞
蕴	藴
臜	臢
杂	雜
载	載
傤	儎
攒	攢
趱	趲
暂	暫
赞	贊
錾	鏨
瓒	瓚
赃	贜
驵	駔
脏	髒 臟
凿	鑿
枣	棗
灶	竈
则	則
择	擇
泽	澤
责	責
啧	嘖
帻	幘
箦	簀
赜	賾
贼	賊
鲗	鰂
谮	譖
缯	繒
锃	鋥
赠	贈
闸	閘
铡	鍘
鲊	鮓
鲝	鮺
诈	詐
斋	齋
债	債
毡	氈
谵	譫
𫗴	饘
鹯	鸇
鳣	鱣
斩	斬
飐	颭
盏	盞
崭	嶄
战	戰
栈	棧
绽	綻
张	張
长	長
涨	漲
帐	帳
胀	脹
账	賬
钊	釗
𬬿	鉊
诏	詔
赵	趙
𬶐	鮡
折	折 摺
辄	輒
蛰	蟄
詟	讋
谪	謫
辙	轍
锗	鍺
这	這
鹧	鷓
贞	貞
针	針
侦	偵
浈	湞
桢	楨
祯	禎
诊	診
轸	軫
缜	縝
阵	陣
纼	紖
鸩	鴆
赈	賑
镇	鎮
征	徵 征
诤	諍
钲	鉦
铮	錚
证	證
郑	鄭
帧	幀
症	症 癥
织	織
执	執
职	職
絷	縶
踯	躑
只	衹 隻 只
纸	紙
轵	軹
制	製 制
帜	幟
质	質
栉	櫛
挚	摯
致	致 緻
贽	贄
轾	輊
掷	擲
铚	銍
鸷	鷙
𬃊	櫍
滞	滯
骘	騭
锧	鑕
觯	觶
踬	躓
终	終
钟	鐘 鍾
锺	鍾
肿	腫
种	種 种
众	衆
诌	謅
诪	譸
辀	輈
鸼	鵃
赒	賙
轴	軸
纣	紂
㑇	㑳
㤘	㥮
绉	縐
昼	晝
荮	葤
皱	皺
骤	驟
朱	朱 硃
诛	誅
诸	諸
铢	銖
槠	櫧
烛	燭
𬣞	詝
嘱	囑
瞩	矚
纻	紵
苎	苧
贮	貯
驻	駐
筑	築 筑
铸	鑄
专	專
䏝	膞
砖	磚
颛	顓
转	轉
啭	囀
赚	賺
馔	饌
妆	妝
庄	莊
桩	樁
装	裝
壮	壯
状	狀
骓	騅
锥	錐
坠	墜
缀	綴
缒	縋
赘	贅
谆	諄
准	準 准
𬘯	綧
䦃	鐯
浊	濁
诼	諑
𬸦	鷟
镯	鐲
赀	貲
资	資
缁	緇
谘	諮
辎	輜
锱	錙
镃	鎡
龇	齜
鲻	鯔
渍	漬
综	綜
总	總
纵	縱
疭	瘲
邹	鄒
驺	騶
诹	諏
鲰	鯫
镞	鏃
诅	詛
组	組
钻	鑽
躜	躦
缵	纘
𨱔	鐏
鳟	鱒
鿒	鿓
鿔	鎶
㐽	偑
㑈	倲
㑔	㑯
㑩	儸
㓆	𠗣
㓥	劏
㓰	劃
㔉	劚
㖊	噚
㖞	喎
㚯	㜄
㛀	媰
㛠	𡢃
㛣	㜏
㛤	孋
㛿	𡠹
㟆	㠏
㟜	𡾱
㟥	嵾
㡎	幓
㤽	懤
㥪	慺
㧏	掆
㧰	擽
㨫	㩜
㭏	椲
㭣	𣙎
㭤	樢
㭴	樫
㱩	殰
㱮	殨
㲿	瀇
㳔	濧
㳕	灡
㳠	澾
㳡	濄
㳢	𣾷
㳽	瀰
㴋	潚
㶉	鸂
㶶	燶
㶽	煱
㺍	獱
㻅	璯
㻏	𤫩
㻘	𤪺
䀥	䁻
䂵	碽
䅉	稏
䅪	𥢢
䉤	籔
䌶	䊷
䌸	縳
䌺	䋙
䌻	䋚
䌼	綐
䌾	䋻
䌿	䋹
䍀	繿
䍁	繸
䍠	䍦
䎬	䎱
䓓	薵
䓕	薳
䘛	𧝞
䘞	𧜗
䙊	𧜵
䙌	䙡
䙓	襬
䜤	鿁
䜥	𧩙
䜧	䜀
䞌	𧵳
䞍	䝼
䞎	𧶧
䞐	賰
䟢	躎
䢀	𨊰
䢁	𨊸
䢂	𨋢
䥺	釾
䥾	䥱
䥿	𨯅
䦀	𨦫
䦁	𨧜
䦂	䥇
䦅	鐥
䦶	䦛
䦷	䦟
䭪	𩞯
䯃	𩣑
䯄	騧
䯅	䯀
䲝	䱽
䲞	𩶘
䲣	䱷
𠀾	𠁞
𠆲	儣
𠆿	𠌥
𠇹	俓
𠉂	㒓
𠉗	𠏢
𠋆	儭
𠚳	𠠎
𠛅	剾
𠛆	𠞆
𠛾	𪟖
𠮶	嗰
𠯟	哯
𠯠	噅
𠰱	㘉
𠰷	嚧
𠱞	囃
𠲥	𡅏
𠴛	𡃕
𠴢	𡄔
𠵸	𡄣
𠵾	㗲
𡋀	𡓾
𡋗	𡑭
𡋤	壗
𡍣	𡔖
𡝠	㜷
𡞋	㜗
𡞱	㜢
𡠟	孎
𡥧	孻
𡭜	𡮉
𡭬	𡮣
𡳃	𡳳
𡳒	𦘧
𡶴	嵼
𡸃	𡽗
𡺃	嶈
𡺄	嶘
𢋈	㢝
𢗓	㦛
𢘙	𢤱
𢘝	𢣚
𢘞	𢣭
𢙏	愻
𢙐	憹
𢙑	𢠼
𢙒	憢
𢙓	懀
𢛯	㦎
𢠁	懎
𢢐	𤢻
𢧐	戰
𢫊	𢷮
𢫞	𢶫
𢫬	摋
𢬍	擫
𢬦	𢹿
𢽾	斅
𣆐	曥
𣈣	𣋋
𣍨	𦢈
𣍯	腪
𣍰	脥
𣎑	臗
𣏢	槫
𣐕	桱
𣑶	𣠲
𣒌	楇
𣓿	橯
𣔌	樤
𣗊	樠
𣗙	㰙
𣘐	㯤
𣘓	𣞻
𣘴	檭
𣘷	𣝕
𣚚	欘
𣞎	𣠩
𣨼	殢
𣭤	𣯴
𣯣	𣯩
𣱝	氭
𣳆	㵗
𣶩	澅
𣶫	𣿉
𣶭	𪷓
𣷷	𤅶
𣺼	灙
𣺽	𤁣
𣽷	瀃
𤆡	熓
𤆢	㷍
𤇃	爄
𤇄	熌
𤇭	爖
𤇹	熚
𤈶	熉
𤈷	㷿
𤊀	𤒎
𤊰	𤓩
𤋏	熡
𤎺	𤓎
𤎻	𤑳
𤙯	𤛮
𤝢	𤢟
𤞃	獩
𤞤	玁
𤠋	㺏
𤦀	瓕
𤳄	𤳸
𤶊	癐
𤶧	𤸫
𤻊	㿗
𤽯	㿧
𤾀	皟
𤿲	麬
𥁢	䀉
𥅘	𥌃
𥅴	䀹
𥅿	𥊝
𥆧	瞤
𥇢	䁪
𥎝	䂎
𥐟	礒
𥐯	𥖅
𥐰	𥕥
𥐻	碙
𥞦	𥞵
𥧂	𥨐
𥩺	𥪂
𥫣	籅
𥬀	䉙
𥬞	籋
𥬠	篘
𥭉	𥵊
𥮋	𥸠
𥮜	䉲
𥮾	篸
𥹥	𥼽
𥺅	䊭
𥺇	𥽖
𦈈	𥿊
𦈉	緷
𦈋	綇
𦈌	綀
𦈎	繟
𦈏	緍
𦈐	縺
𦈑	緸
𦈒	𦂅
𦈓	䋿
𦈔	縎
𦈕	緰
𦈖	䌈
𦈗	𦃄
𦈘	䌋
𦈙	䌰
𦈚	縬
𦈛	繓
𦈜	䌖
𦈝	繏
𦈞	䌟
𦈟	䌝
𦈠	䌥
𦍠	䍽
𦛨	朥
𦟗	𦣎
𦨩	𦪽
𦰏	蓧
𦰴	䕳
𦶟	爇
𦻕	蘟
𧉐	𧕟
𧉞	䗿
𧌥	𧎈
𧏖	蠙
𧏗	蠀
𧑏	蠾
𧒭	𧔥
𧜭	䙱
𧝝	襰
𧝧	𧟀
𧮪	詀
𧳕	𧳟
𧹑	䞈
𧹒	買
𧹓	𧶔
𧹔	賬
𧹕	䝻
𧹖	賟
𧹗	贃
𧿈	𨇁
𨀁	躘
𨀱	𨄣
𨁴	𨅍
𨂺	𨈊
𨄄	𨈌
𨅛	䠱
𨅫	𨇞
𨅬	躝
𨉗	軉
𨐅	軗
𨐆	𨊻
𨐇	𨏠
𨐉	𨎮
𨐊	𨏥
𨑹	䢨
𨟳	𨣞
𨠨	𨣧
𨡙	𨢿
𨡺	𨣈
𨤰	𨤻
𨰾	鎷
𨰿	釳
𨱀	𨥛
𨱁	鈠
𨱂	鈋
𨱃	鈲
𨱄	鈯
𨱅	鉁
𨱆	龯
𨱈	鋉
𨱉	鍄
𨱊	𨧱
𨱋	錂
𨱌	鏆
𨱍	鎯
𨱎	鍮
𨱐	𨫒
𨱒	鏉
𨱓	鐎
𨱕	𨮂
𨱖	䥩
𨷿	䦳
𨸀	𨳕
𨸁	𨳑
𨸂	閍
𨸃	閐
𨸄	䦘
𨸅	𨴗
𨸆	𨵩
𨸇	𨵸
𨸉	𨶀
𨸋	𨶲
𨸌	𨶮
𨸎	𨷲
𨸘	𨽏
𨸟	䧢
𩏼	䪏
𩏽	𩏪
𩏿	䪘
𩐀	䪗
𩓋	顂
𩖕	𩓣
𩖖	顃
𩖗	䫴
𩙥	颰
𩙦	𩗀
𩙧	䬞
𩙨	𩘹
𩙩	𩘀
𩙫	颾
𩙬	𩘺
𩙭	𩘝
𩙮	䬘
𩙯	䬝
𩙰	𩙈
𩟿	𩚛
𩠀	𩚥
𩠁	𩚵
𩠂	𩛆
𩠃	𩛩
𩠅	𩟐
𩠆	𩜦
𩠇	䭀
𩠈	䭃
𩠉	𩜇
𩠊	𩜵
𩠋	𩝔
𩠌	餸
𩠎	𩞄
𩠏	𩞦
𩠠	𩠴
𩡖	𩡣
𩧦	𩡺
𩧨	駎
𩧩	𩤊
𩧪	䮾
𩧫	駚
𩧬	𩢡
𩧭	䭿
𩧮	𩢾
𩧯	驋
𩧰	䮝
𩧱	𩥉
𩧲	駧
𩧳	𩢸
𩧴	駩
𩧵	𩢴
𩧸	𩣫
𩧺	駶
𩧻	𩣵
𩧼	𩣺
𩧿	䮠
𩨀	騔
𩨁	䮞
𩨂	驄
𩨃	騝
𩨄	騪
𩨅	𩤸
𩨆	𩤙
𩨇	䮫
𩨈	騟
𩨉	𩤲
𩨊	騚
𩨋	𩥄
𩨌	𩥑
𩨍	𩥇
𩨎	龭
𩨏	䮳
𩨐	𩧆
𩩈	䯤
𩬣	𩭙
𩬤	𩰀
𩭹	鬖
𩯒	𩯳
𩰰	𩰹
𩲒	𩳤
𩴌	𩴵
𩽹	魥
𩽺	𩵩
𩽻	𩵹
𩽼	鯶
𩽽	𩶱
𩽿	𩶰
𩾁	鯄
𩾂	䲖
𩾄	𩷰
𩾅	𩸃
𩾆	𩸦
𩾇	鯱
𩾈	䱙
𩾊	䱬
𩾋	䱰
𩾎	𩽇
𪉂	䲰
𪉃	鳼
𪉄	𩿪
𪉅	𪀦
𪉆	鴲
𪉈	鴜
𪉉	𪁈
𪉊	鷨
𪉋	𪀾
𪉌	𪁖
𪉍	鵚
𪉎	𪂆
𪉏	𪃏
𪉐	𪃍
𪉑	鷔
𪉒	𪄕
𪉔	𪄆
𪉕	𪇳
𪎈	䴬
𪎉	麲
𪎊	麨
𪎋	䴴
𪎌	麳
𪑅	䵳
𪔭	𪔵
𪚏	𪘀
𪚐	𪘯
𪜎	𠿕
𪞝	凙
𪟎	㔋
𪠀	𧷎
𪠟	㓄
𪠡	𠬙
𪠳	唓
𪠵	㖮
𪠸	嚛
𪠺	𠽃
𪠽	噹
𪡀	嘺
𪡃	嘪
𪡋	噞
𪡏	嗹
𪡛	㗿
𪡞	嘳
𪡺	𡃄
𪢌	㘓
𪢐	𡃤
𪢒	𡂡
𪢕	嚽
𪢖	𡅯
𪢠	囒
𪢮	圞
𪢸	墲
𪣆	埬
𪣒	堚
𪤄	𡓁
𪤚	壣
𪥠	𧹈
𪥫	孇
𪥰	嬣
𪥿	嬻
𪧀	孾
𪧘	寠
𪨊	㞞
𪨗	屩
𪨩	𡸗
𪨹	𡹬
𪩇	㟺
𪩎	巊
𪩛	𡿖
𪩷	幝
𪩸	幩
𪪏	廬
𪪑	㢗
𪪞	廧
𪪴	𢍰
𪪼	彃
𪫌	徿
𪫡	𢤩
𪫷	㦞
𪫺	憸
𪬚	𢣐
𪬯	𢤿
𪭝	𢯷
𪭢	摐
𪭧	擟
𪭯	𢶒
𪭵	掚
𪭾	撊
𪮃	㨻
𪮋	㩋
𪮖	撧
𪮳	𢺳
𪮶	攋
𪯋	㪎
𪰶	曊
𪱥	膹
𪱷	梖
𪲎	櫅
𪲔	欐
𪲛	檵
𪲮	櫠
𪳍	欇
𪳗	𣜬
𪴙	欑
𪵑	毊
𪵣	霼
𪵱	濿
𪶄	溡
𪶒	𤄷
𪶮	𣽏
𪷍	㵾
𪷽	灒
𪸕	熂
𪹀	𤑹
𪹠	𤓌
𪹳	爥
𪹹	𤒻
𪺣	𤘀
𪺪	𤜆
𪺭	犞
𪺷	獊
𪺸	𤠮
𪺻	㺜
𪺽	猌
𪻐	瑽
𪻨	瓄
𪻲	瑻
𪻺	璝
𪼋	㻶
𪼴	𤬅
𪽈	畼
𪽝	𤳷
𪽪	痮
𪽭	𤷃
𪽮	㿖
𪽴	𤺔
𪽷	瘱
𪾔	盨
𪾣	眝
𪾦	矑
𪾸	矉
𪿊	𥏝
𪿞	𥖲
𪿵	𥗇
𫀌	𥜰
𫀓	𥜐
𫀨	䅐
𫀬	䅳
𫀮	𥢷
𫁂	䆉
𫁟	竱
𫁡	鴗
𫁱	𥶽
𫁲	䉑
𫁳	𥯤
𫁷	䉶
𫁺	𥴼
𫂃	簢
𫂆	簂
𫂈	䉬
𫂖	𥴨
𫂿	𥻦
𫃗	𩏷
𫄚	䊺
𫄛	紟
𫄜	䋃
𫄝	𥾯
𫄞	䋔
𫄟	絁
𫄠	絙
𫄡	絧
𫄢	絥
𫄣	繷
𫄤	繨
𫄥	纚
𫄦	𦀖
𫄩	䋦
𫄪	𦅇
𫄫	綟
𫄬	緤
𫄭	緮
𫄮	䋼
𫄯	𦃩
𫄰	縍
𫄱	繬
𫄲	縸
𫄳	縰
𫄴	繂
𫄵	𦅈
𫄹	纗
𫅅	䍤
𫅗	羵
𫅥	𦒀
𫅭	䎙
𫅼	𦔖
𫆏	聻
𫆝	𦟼
𫆫	𦡝
𫇘	𦧺
𫇪	𦱌
𫇽	蕽
𫈉	蕳
𫈎	葝
𫈟	蔯
𫈵	蕝
𫉁	薆
𫊪	䗅
𫊮	蠦
𫊸	蟜
𫊹	𧒯
𫊻	蟳
𫋇	蟂
𫋌	蟘
𫋲	䙔
𫋷	襗
𫋹	襓
𫋻	襘
𫌇	襵
𫌋	𧞫
𫌨	覼
𫌪	覛
𫌫	𧡴
𫌬	𧢄
𫌭	覹
𫌯	䚩
𫍐	𧭹
𫍙	訑
𫍚	訞
𫍛	訜
𫍜	詓
𫍝	諫
𫍞	𧦝
𫍟	𧦧
𫍠	䛄
𫍡	詑
𫍢	譊
𫍤	譑
𫍥	誂
𫍦	譨
𫍧	誺
𫍨	誫
𫍩	諣
𫍪	誋
𫍫	䛳
𫍬	誷
𫍭	𧩕
𫍮	誳
𫍰	諰
𫍱	諯
𫍳	諥
𫍴	謱
𫍵	謸
𫍶	𧩼
𫍷	謉
𫍸	謆
𫍹	謯
𫍺	𧫝
𫍼	𧬤
𫍾	𧭈
𫍿	譾
𫎆	豵
𫎌	貗
𫎦	贚
𫎧	䝭
𫎨	𧸘
𫎩	賝
𫎪	䞋
𫎫	贉
𫎭	䞓
𫎱	䟐
𫎳	䟆
𫎸	𧽯
𫎺	䟃
𫏃	䠆
𫏆	蹳
𫏌	𨂐
𫏑	𨇽
𫏕	𨆪
𫏞	𨇰
𫏨	𨇤
𫐅	軕
𫐆	轣
𫐇	軜
𫐈	軷
𫐉	軨
𫐊	軬
𫐋	𨎌
𫐌	軿
𫐍	𨌈
𫐎	輢
𫐏	輖
𫐑	輨
𫐒	輷
𫐔	𨍰
𫐕	轊
𫐖	轇
𫐗	轐
𫐘	轗
𫐙	轠
𫐷	遱
𫑘	鄟
𫑷	醶
𫓥	釟
𫓦	釨
𫓨	鈛
𫓩	鏦
𫓫	𨥟
𫓬	鉔
𫓭	鉠
𫓮	𨪕
𫓰	銊
𫓱	鐈
𫓲	銁
𫓳	𨰋
𫓴	鉾
𫓵	鋠
𫓷	𫒡
𫓸	錽
𫓺	鐪
𫓻	錜
𫓼	𨨛
𫓽	錝
𫓾	錥
𫓿	𨨢
𫔁	鐼
𫔂	鍉
𫔃	𨰲
𫔄	鍒
𫔅	鎍
𫔆	䥯
𫔇	鎞
𫔈	鎙
𫔉	𨰃
𫔊	鏥
𫔋	䥗
𫔌	鏾
𫔏	𨬖
𫔐	𨭸
𫔑	𨭖
𫔒	𨮳
𫔓	𨯟
𫔔	鑴
𫔕	𨰥
𫔖	𨲳
𫔭	開
𫔰	閞
𫔲	𨴹
𫔴	閵
𫔵	䦯
𫔽	𨼳
𫕚	𩀨
𫕥	霣
𫕨	𩅙
𫖃	靧
𫖅	䪊
𫖑	𩎖
𫖒	韠
𫖓	𩏂
𫖔	韛
𫖖	𩏠
𫖪	𩑔
𫖫	䪴
𫖬	䪾
𫖭	𩒎
𫖰	䫂
𫖱	䫀
𫖲	䫟
𫖴	𩔳
𫖵	𩓥
𫖶	顅
𫖷	𩔑
𫖸	願
𫖹	顣
𫖺	䫶
𫗇	䫻
𫗈	𩗓
𫗉	𩗴
𫗊	䬓
𫗋	飋
𫗚	𩟗
𫗞	飦
𫗟	䬧
𫗠	餦
𫗡	𩚩
𫗢	飵
𫗣	飶
𫗤	𩛌
𫗥	餫
𫗦	餔
𫗨	𩛡
𫗩	饠
𫗬	餪
𫗮	餭
𫗰	䭔
𫗱	䭑
𫗳	𩝽
𫘛	馯
𫘟	駊
𫘠	駤
𫘡	駫
𫘣	駻
𫘤	騃
𫘥	騉
𫘩	騜
𫘫	騴
𫘭	騻
𫘮	䮰
𫘯	驓
𫘰	驙
𫘱	驨
𫘽	鬠
𫙂	𩯁
𫚈	鱮
𫚉	魟
𫚊	鰑
𫚋	鱄
𫚌	魦
𫚍	魵
𫚎	𩶁
𫚏	䱁
𫚐	䱀
𫚑	鮅
𫚒	鮄
𫚓	鮤
𫚔	鮰
𫚗	鮯
𫚘	𩻮
𫚙	鯆
𫚚	鮿
𫚛	鮵
𫚜	䲅
𫚝	𩸄
𫚞	鯬
𫚟	𩸡
𫚠	䱧
𫚡	鯞
𫚢	鰋
𫚣	鯾
𫚤	鰦
𫚥	鰕
𫚦	鰫
𫚧	鰽
𫚨	𩻗
𫚩	𩻬
𫚪	鱊
𫚫	鱢
𫚬	𩼶
𫛚	鳽
𫛛	鳷
𫛜	鴀
𫛝	鴅
𫛞	鴃
𫛟	鸗
𫛠	𩿤
𫛡	鴔
𫛢	鸋
𫛣	鴥
𫛤	鴐
𫛥	鵊
𫛦	鴮
𫛧	𪀖
𫛨	鵧
𫛩	鴳
𫛪	鴽
𫛫	鶰
𫛬	䳜
𫛮	䳤
𫛯	鶭
𫛰	䳢
𫛱	鵫
𫛳	鵩
𫛴	鷤
𫛵	鶌
𫛶	鶒
𫛷	鶦
𫛸	鶗
𫛹	𪃧
𫛺	䳧
𫛻	𪃒
𫛼	䳫
𫛽	鷅
𫛾	𪆷
𫜀	鷐
𫜁	鷩
𫜂	𪅂
𫜃	鷣
𫜄	鷷
𫜅	䴋
𫜊	𪉸
𫜑	麷
𫜒	䴱
𫜓	𪌭
𫜔	䴽
𫜕	𪍠
𫜙	䵴
𫜟	𪓰
𫜨	䶕
𫜫	𫜦
𫜬	齰
𫜭	齭
𫜮	齴
𫜯	𪙏
𫜰	齾
𫜲	龓
𫜳	䶲
𫝈	㑮
𫝋	𠐊
𫝦	㛝
𫝧	㜐
𫝨	媈
𫝩	嬦
𫝪	𡟫
𫝫	婡
𫝬	嬇
𫝭	孆
𫝮	孄
𫝵	嶹
𫞅	𦠅
𫞗	潣
𫞚	澬
𫞛	㶆
𫞝	灍
𫞠	爧
𫞡	爃
𫞢	𤛱
𫞣	㹽
𫞥	珼
𫞦	璾
𫞧	𤩂
𫞨	璼
𫞷	𥢶
𫟃	絍
𫟄	綋
𫟆	緟
𫟇	𦆲
𫟑	䖅
𫟕	䕤
𫟞	訨
𫟟	詊
𫟠	譂
𫟡	誴
𫟢	䜖
𫟤	䡐
𫟥	䡩
𫟫	𨞺
𫟬	𨟊
𫟲	釚
𫟳	釲
𫟴	鈖
𫟵	鈗
𫟶	銏
𫟷	鉝
𫟸	鉽
𫟺	䤤
𫟻	銂
𫟽	𨧰
𫟾	𨩰
𫟿	鎈
𫠀	䥄
𫠁	鑉
𫠂	閝
𫠅	韚
𫠇	𩖰
𫠈	䫾
𫠋	騼
𫠌	𩦠
𫠏	𩵦
𫠐	魽
𫠑	䱸
𫠒	鱆
𫠖	𩿅
𫧃	𣍐
𫧮	𪋿
𫬐	㘔
𬭭	鏚
𬸯	鷿
𰰨	菕
𰶎	譅
𰾄	鋂
𰾭	鑀
𱊜	𪈼
