𠗣	㓆
𡞵	㛟
𡢃	㛠
𣙎	㭣
𣾷	㳢
𤪺	㻘
𧜗	䘞
𧝞	䘛
𧩙	䜥
𧶧	䞎
𨋢	䢂
𨦫	䦀
𨧜	䦁
𨯅	䥿
𩣑	䯃
𠁞	𠀾
𠌥	𠆿
𠏢	𠉗
𠐊	𫝋
𠞆	𠛆
𠠎	𠚳
𠬙	𪠡
𠽃	𪠺
𠿕	𪜎
𡂡	𪢒
𡃄	𪡺
𡃕	𠴛
𡃤	𪢐
𡄔	𠴢
𡄣	𠵸
𡅏	𠲥
𡅯	𪢖
𡑍	𫭼
𡑭	𡋗
𡓁	𪤄
𡓾	𡋀
𡔖	𡍣
𡟫	𫝪
𡮉	𡭜
𡮣	𡭬
𡳳	𡳃
𡸗	𪨩
𡹬	𪨹
𡽗	𡸃
𡿖	𪩛
𢍰	𪪴
𢠼	𢙑
𢣐	𪬚
𢣚	𢘝
𢣭	𢘞
𢤩	𪫡
𢤱	𢘙
𢤿	𪬯
𢯷	𪭝
𢶒	𪭯
𢶫	𢫞
𢷮	𢫊
𢹿	𢬦
𢺳	𪮳
𣋋	𣈣
𣍐	𫧃
𣜬	𪳗
𣝕	𣘷
𣞻	𣘓
𣠩	𣞎
𣠲	𣑶
𣯩	𣯣
𣯴	𣭤
𣽏	𪶮
𣿉	𣶫
𤁣	𣺽
𤄷	𪶒
𤅶	𣷷
𤑳	𤎻
𤑹	𪹀
𤒎	𤊀
𤒻	𪹹
𤓌	𪹠
𤓎	𤎺
𤓩	𤊰
𤘀	𪺣
𤛮	𤙯
𤛱	𫞢
𤜆	𪺪
𤠮	𪺸
𤢟	𤝢
𤢻	𢢐
𤩂	𫞧
𤬅	𪼴
𤳷	𪽝
𤳸	𤳄
𤷃	𪽭
𤸫	𤶧
𤺔	𪽴
𥊝	𥅿
𥌃	𥅘
𥏝	𪿊
𥕥	𥐰
𥖅	𥐯
𥖲	𪿞
𥗇	𪿵
𥗽	𬒗
𥜐	𫀓
𥜰	𫀌
𥞵	𥞦
𥢶	𫞷
𥢷	𫀮
𥨐	𥧂
𥪂	𥩺
𥯤	𫁳
𥴨	𫂖
𥴼	𫁺
𥵊	𥭉
𥶽	𫁱
𥸠	𥮋
𥻦	𫂿
𥼽	𥹥
𥽖	𥺇
𥾯	𫄝
𥿊	𦈈
𦀖	𫄦
𦂅	𦈒
𦃄	𦈗
𦃩	𫄯
𦅇	𫄪
𦅈	𫄵
𦆲	𫟇
𦒀	𫅥
𦔖	𫅼
𦘧	𡳒
𦟼	𫆝
𦠅	𫞅
𦡝	𫆫
𦢈	𣍨
𦣎	𦟗
𦧺	𫇘
𦪽	𦨩
𦱌	𫇪
𦾟	𦶻
𧎈	𧌥
𧒯	𫊹
𧔥	𧒭
𧕟	𧉐
𧞫	𫌋
𧟀	𧝧
𧡴	𫌫
𧢄	𫌬
𧦝	𫍞
𧦧	𫍟
𧩕	𫍭
𧩼	𫍶
𧫝	𫍺
𧬤	𫍼
𧭈	𫍾
𧭹	𫍐
𧳟	𧳕
𧶔	𧹓
𧷎	𪠀
𧸘	𫎨
𧹈	𪥠
𧽯	𫎸
𨂐	𫏌
𨄣	𨀱
𨅍	𨁴
𨆪	𫏕
𨇁	𧿈
𨇞	𨅫
𨇤	𫏨
𨇰	𫏞
𨇽	𫏑
𨈊	𨂺
𨈌	𨄄
𨊻	𨐆
𨌈	𫐍
𨍰	𫐔
𨎌	𫐋
𨎮	𨐉
𨏠	𨐇
𨏥	𨐊
𨞺	𫟫
𨟊	𫟬
𨢿	𨡙
𨣈	𨡺
𨣞	𨟳
𨣧	𨠨
𨤻	𨤰
𨥛	𨱀
𨥟	𫓫
𨧀	𬭊
𨧰	𫟽
𨧱	𨱊
𨨏	𬭛
𨨛	𫓼
𨨢	𫓿
𨩰	𫟾
𨪕	𫓮
𨫒	𨱐
𨬖	𫔏
𨭆	𬭶
𨭎	𬭳
𨭖	𫔑
𨭸	𫔐
𨮂	𨱕
𨮳	𫔒
𨯟	𫔓
𨰃	𫔉
𨰋	𫓳
𨰥	𫔕
𨰲	𫔃
𨲳	𫔖
𨳑	𨸁
𨳕	𨸀
𨴗	𨸅
𨴹	𫔲
𨵩	𨸆
𨵸	𨸇
𨶀	𨸉
𨶮	𨸌
𨶲	𨸋
𨷲	𨸎
𨼳	𫔽
𨽏	𨸘
𩀨	𫕚
𩅙	𫕨
𩎖	𫖑
𩏂	𫖓
𩏠	𫖖
𩏪	𩏽
𩏷	𫃗
𩑔	𫖪
𩒎	𫖭
𩓣	𩖕
𩓥	𫖵
𩔑	𫖷
𩔳	𫖴
𩖰	𫠇
𩗀	𩙦
𩗓	𫗈
𩗴	𫗉
𩘀	𩙩
𩘝	𩙭
𩘹	𩙨
𩘺	𩙬
𩙈	𩙰
𩚛	𩟿
𩚥	𩠀
𩚩	𫗡
𩚵	𩠁
𩛆	𩠂
𩛌	𫗤
𩛡	𫗨
𩛩	𩠃
𩜇	𩠉
𩜦	𩠆
𩜵	𩠊
𩝔	𩠋
𩝽	𫗳
𩞄	𩠎
𩞦	𩠏
𩟐	𩠅
𩟗	𫗚
𩠴	𩠠
𩡣	𩡖
𩡺	𩧦
𩢡	𩧬
𩢴	𩧵
𩢸	𩧳
𩢾	𩧮
𩣫	𩧸
𩣵	𩧻
𩣺	𩧼
𩤊	𩧩
𩤙	𩨆
𩤲	𩨉
𩤸	𩨅
𩥄	𩨋
𩥇	𩨍
𩥉	𩧱
𩥑	𩨌
𩦠	𫠌
𩧆	𩨐
𩭙	𩬣
𩯁	𫙂
𩯳	𩯒
𩰀	𩬤
𩰹	𩰰
𩳤	𩲒
𩴵	𩴌
𩵦	𫠏
𩵩	𩽺
𩵹	𩽻
𩶁	𫚎
𩶰	𩽿
𩶱	𩽽
𩷰	𩾄
𩸃	𩾅
𩸄	𫚝
𩸡	𫚟
𩸦	𩾆
𩻗	𫚨
𩻬	𫚩
𩻮	𫚘
𩼶	𫚬
𩽇	𩾎
𩿅	𫠖
𩿤	𫛠
𩿪	𪉄
𪀖	𫛧
𪀦	𪉅
𪀾	𪉋
𪁈	𪉉
𪁖	𪉌
𪂆	𪉎
𪃍	𪉐
𪃏	𪉏
𪃒	𫛻
𪃧	𫛹
𪄆	𪉔
𪄕	𪉒
𪅂	𫜂
𪆷	𫛾
𪇳	𪉕
𪈼	𱊜
𪉸	𫜊
𪋿	𫧮
𪌭	𫜓
𪍠	𫜕
𪓰	𫜟
𪔵	𪔭
𪘀	𪚏
𪘯	𪚐
𪙏	𫜯
𪟖	𠛾
𪷓	𣶭
𫒡	𫓷
𫜦	𫜫
䊷	䌶
䱽	䲝
鿁	䜤
鿓	鿒
㜢	𡞱
㞞	𪨊
㢝	𢋈
㷿	𤈷
㸇	𤎺
䉶	𫁷
䋿	𦈓
䌋	𦈘
䎙	𫅭
䕤	𫟕
䙔	𫋲
䝻	𧹕
䞓	𫎭
䢨	𨑹
䤤	𫟺
䧢	𨸟
䬘	𩙮
䭔	𫗰
䮠	𩧿
䱀	𫚐
䱙	𩾈
䱧	𫚠
䱬	𩾊
䱸	𫠑
䲅	𫚜
䳤	𫛮
壗	𡋤
朥	𦛨
鯱	𩾇
龭	𩨎
龯	𨱆
錒	锕
捱	挨
鎄	锿
皚	皑
騃	𫘤
噯	嗳
藹	蔼
靄	霭
嬡	嫒
愛	爱
曖	暧
璦	瑷
礙	碍
薆	𫉁
鑀	𰾭
靉	叆
諳	谙
鞌	鞍
鵪	鹌
晻	暗
銨	铵
㟁	岸
䬓	𫗊
菴	庵
闇	暗
鮟	𩽾
骯	肮
囂	嚣
簢	𫂃
翺	翱
謸	𫍵
鰲	鳌
鼇	鳌
媼	媪
抝	拗
襖	袄
㘭	坳
奧	奥
驁	骜
釟	𫓥
軷	𫐈
鈸	钹
颰	𩙥
鈀	钯
䆉	𫁂
䎱	䎬
䥯	𫔆
䰾	鲃
垻	坝
壩	坝
罷	罢
覇	霸
鮁	鲅
鮊	鲌
擺	摆
栢	柏
襬	摆
䴽	𫜔
唄	呗
敗	败
粺	稗
頒	颁
㺜	𪺻
岅	坂
板	板
鈑	钣
闆	板
阪	阪 坂
絆	绊
辦	办
幇	帮
幚	帮
幫	帮
縍	𫄰
牓	榜
綁	绑
髈	膀
謗	谤
鎊	镑
襃	褒
齙	龅
寳	宝
寶	宝
緥	褓
飽	饱
鴇	鸨
報	报
鉋	刨
鑤	刨
鮑	鲍
揹	背
桮	杯
盃	杯
鵯	鹎
鉳	锫
㛝	𫝦
俻	备
偹	备
備	备
憊	惫
梖	𪱷
狽	狈
珼	𫞥
誖	悖
貝	贝
軰	辈
輩	辈
鋇	钡
韛	𫖔
犇	奔 犇
賁	贲
逩	奔
錛	锛
綳	绷
繃	绷
閍	𨸂
鏰	镚
偪	逼
㻶	𪼋
筆	笔
粃	秕
䋔	𫄞
䌟	𦈞
䟆	𫎳
䦘	𨸄
䫾	𫠈
嗶	哔
幣	币
𡚁	弊
彃	𪪼
斃	毙
潷	滗
熚	𤇹
獘	毙
畢	毕
痺	痹
篳	筚
蓽	荜
詖	诐
贔	赑
蹕	跸
辟	辟
鉍	铋
鎞	𫔇
閉	闭
闢	辟
韠	𫖒
飶	𫗣
鮅	𫚑
鰏	鲾
鷩	𫜁
獱	㺍
籩	笾
編	编
邊	边
鯾	𫚣
鯿	鳊
貶	贬
㳒	法
徧	遍
緶	缏
變	变
辮	辫
辯	辩
閞	𫔰
標	标
羆	罴
臕	膘
鏢	镖
鑣	镳
颮	飑
颷	飙
飆	飙
飇	飙
驃	骠
驫	骉
表	表
錶	表
鰾	鳔
癟	瘪
鱉	鳖
鼈	鳖
別	别
别	别
㿜	瘪
䉲	𥮜
彆	别
儐	傧
檳	槟
濱	滨
瀕	濒
璸	瑸
矉	𪾸
繽	缤
蠙	𧏖
賓	宾
鑌	镔
擯	摈
殯	殡
臏	膑
髕	髌
鬢	鬓
氷	冰
竝	并
稟	禀
餅	饼
並	并
併	并
鵧	𫛨
剝	剥
彂	发
撥	拨
盋	钵
缽	钵
襏	袯
蹳	𫏆
鉢	钵
餑	饽
驋	𩧯
愽	博
簙	博
𩓐	脖
鉑	铂
鎛	镈
餺	馎
駁	驳
駮	驳
鵓	鹁
卜	卜
蔔	卜
鈽	钸
餔	𫗦
鵏	𬷕
補	补
佈	布
鈈	钚
䟃	𫎺
囃	𠱞
才	才
纔	才
財	财
倸	睬
寀	采
採	采
綵	彩
跴	踩
埰	采
㕘	参
參	参
叄	叁
蓡	参
驂	骖
鰺	鲹
㨻	𪮃
慙	惭
慚	惭
殘	残
蠶	蚕
㘔	𫬐
㜗	𡞋
慘	惨
黲	黪
摻	掺
燦	灿
倉	仓
傖	伧
滄	沧
艙	舱
蒼	苍
鶬	鸧
𢮥	操
艸	草
側	侧
冊	册
厠	厕
廁	厕
惻	恻
測	测
筞	策
嵾	㟥
層	层
揷	插
鍤	锸
鎈	𫟿
餷	馇
査	查
𦉆	碴
詧	察
鑔	镲
剎	刹
奼	姹
詫	诧
釵	钗
儕	侪
蠆	虿
攙	搀
覘	觇
単	单
單	单
嬋	婵
禪	禅
緾	缠
纏	缠
蟬	蝉
讒	谗
鐔	镡
鑱	镵
饞	馋
㹽	𫞣
剗	刬
剷	铲
嘽	啴
囅	冁
嵼	𡶴
幝	𪩷
滻	浐
燀	𬊤
產	产
産	产
繟	𦈎
蕆	蒇
諂	谄
譂	𫟠
鏟	铲
闡	阐
懴	忏
懺	忏
顫	颤
倀	伥
錩	锠
閶	阊
鯧	鲳
䗅	𫊪
䠆	𫏃
償	偿
嘗	尝
嚐	尝
場	场
塲	场
甞	尝
腸	肠
膓	肠
萇	苌
長	长
鱨	鲿
䠀	蹚
厰	厂
廠	厂
鋹	𬬮
悵	怅
暢	畅
畼	𪽈
𠞰	剿
勦	剿
鈔	钞
濤	涛
鼂	鼌
麨	𪎊
俥	伡
唓	𪠳
硨	砗
車	车
䋲	绳
撦	扯
徹	彻
轍	辙
賝	𫎩
塵	尘
蔯	𫈟
諶	谌
陳	陈
鷐	𫜀
磣	碜
㧱	拿
䞋	𫎪
儭	𠋆
櫬	榇
稱	称
襯	衬
讖	谶
趂	趁
齔	龀
撐	撑
檉	柽
湞	浈
蟶	蛏
赬	赪
鐺	铛
乗	乘
堘	塍
懲	惩
棖	枨
椉	乘
澂	澄 澂
誠	诚
鋮	铖
騁	骋
喫	吃
彲	彨
癡	痴
絺	𫄨
誺	𫍧
鴟	鸱
遲	迟
馳	驰
恥	耻
鶒	𫛶
齒	齿
𩳁	䰡
勅	敕
熾	炽
翄	翅
飭	饬
傭	佣
冲	冲
湧	涌
衝	冲
蟲	虫
寵	宠
銃	铳
篘	𥬠
㦞	𪫷
㿧	𤽯
䊭	𥺅
䲖	𩾂
儔	俦
嬦	𫝩
幬	帱
懤	㤽
疇	畴
籌	筹
綢	绸
薵	䓓
詶	酬
讎	仇 雠
躊	踌
酧	酬
醻	酬
丑	丑
𥄨	瞅
矁	瞅
醜	丑
出	出
貙	䝙
齣	出
㕑	厨
㶆	𫞛
䅳	𫀬
儲	储
幮	㡡
廚	厨
懨	恹
櫥	橱
耡	锄
芻	刍
蒭	刍
躕	蹰
鉏	锄
鋤	锄
雛	雏
処	处
礎	础
處	处
齭	𫜭
齼	𬺓
䮞	𩨁
絀	绌
觸	触
詘	诎
䦟	䦷
傳	传
舩	船
諯	𫍱
釧	钏
刱	创
剏	创
創	创
囪	囱
戧	戗
摐	𪭢
牎	窗
牕	窗
瘡	疮
窓	窗
𥦗	窗
窻	窗
牀	床
搶	抢
闖	闯
剙	创
愴	怆
獊	𪺷
搥	捶
箠	棰
錘	锤
鎚	锤
旾	春
鰆	䲠
湻	淳
純	纯
脣	唇
蒓	莼
蓴	莼
醕	醇
錞	𬭚
鶉	鹑
惷	蠢
嚽	𪢕
綽	绰
輟	辍
齪	龊
㓨	刾
䛐	词
詞	词
辤	辞
辭	辞
餈	糍
鷀	鹚
賜	赐
從	从
怱	匆
悤	匆
樅	枞
瑽	𪻐
聰	聪
蓯	苁
蔥	葱
鍃	锪
鏦	𫓩
騘	骢
驄	骢
叢	丛
従	从
誴	𫟡
錝	𫓽
湊	凑
輳	辏
觕	粗
麤	粗
䥄	𫠀
縬	𦈚
趨	趋
鏃	镞
攛	撺
躥	蹿
鑹	镩
㠝	巑
攅	攒
攢	攒
櫕	攒
濽	𪷽
灒	𪷽
竄	窜
簒	篡
脃	脆
顇	悴
邨	村 邨
嵳	嵯
酇	酂
鹺	鹾
剉	锉
銼	锉
錯	错
齰	𫜬
噠	哒
墶	垯
䃮	鿎
𦪙	䑽
剳	札
𤺥	瘩
繨	𫄤
薘	荙
達	达
鎝	𨱏
鐽	𫟼
闒	阘
韃	鞑
墖	塔
獃	呆
帶	带
瑇	玳
紿	绐
貸	贷
軑	轪
靆	叇
𠫹	单
擔	担
殫	殚
癉	瘅
簞	箪
躭	耽
鄲	郸
酖	鸩
䮰	𫘮
撣	掸
紞	𬘘
膽	胆
僤	𫢸
啗	啖
噉	啖
彈	弹
憚	惮
誕	诞
噹	当
璫	珰
當	当
簹	筜
襠	裆
党	党
擋	挡
攩	挡
檔	档
欓	𣗋
灙	𣺼
讜	谠
黨	党
壋	垱
璗	𬍡
盪	荡
碭	砀
蕩	荡
蘯	荡
魛	鱽
㠀	岛
導	导
島	岛
嶹	𫝵
𢷬	捣
搗	捣
擣	捣
禱	祷
隯	陦
燾	焘
盜	盗
惪	德
鍀	锝
燈	灯
鐙	镫
櫈	凳
鄧	邓
眡	视
磾	䃅
鍉	𫔂
鏑	镝
隄	堤
廸	迪
敵	敌
滌	涤
糴	籴
覿	觌
頔	𬱖
牴	抵
觝	抵
詆	诋
嵽	𫶇
締	缔
蔕	蒂
螮	䗖
諦	谛
遞	递
巔	巅
癲	癫
顛	颠
點	点
墊	垫
淀	淀
澱	淀
鈿	钿
電	电
彫	雕 凋
琱	雕
鯛	鲷
鵰	雕
弔	吊
窵	窎
蓧	𦰏
誂	𫍥
調	调
釣	钓
銚	铫
銱	铞
㬪	叠
曡	叠
疉	叠
疊	叠
絰	绖
蜨	蝶
諜	谍
鰈	鲽
釘	钉
頂	顶
椗	碇
矴	碇
訂	订
鋌	铤
錠	锭
飣	饤
丟	丢
銩	铥
倲	㑈
冬	冬
埬	𪣆
崬	岽
東	东
氭	𣱝
蝀	𬟽
鶇	鸫
鼕	冬
働	动
凍	冻
動	动
峝	峒
棟	栋
腖	胨
駧	𩧲
兠	兜
斗	斗
闘	斗
鬥	斗
鬦	斗
鬪	斗
鬭	斗
竇	窦
荳	豆
讀	读
閗	斗
餖	饾
鬬	斗
闍	阇
䙱	𧜭
凟	渎
匵	椟
嬻	𪥿
櫝	椟
殰	㱩
瀆	渎
牘	牍
犢	犊
獨	独
瓄	𪻨
頓	顿
黷	黩
篤	笃
覩	睹
賭	赌
妬	妒
槖	橐
鍍	镀
耑	专 耑
斷	断
籪	簖
緞	缎
鍛	锻
兌	兑
對	对
懟	怼
濧	㳔
綐	䌼
鐓	镦
隊	队
噸	吨
墪	墩
㥫	惇
㪟	敦
躉	趸
燉	炖
遯	遁
鈍	钝
凙	𪞝
奪	夺
敓	敚
襗	𫋷
鐸	铎
鮵	𫚛
䫂	𫖰
嚲	亸
垜	垛
朶	朵
綞	缍
軃	亸
墮	堕
跥	跺
飿	饳
馱	驮
娿	婀
痾	疴
䳘	鹅
峩	峨
訛	讹
譌	讹
鈋	𨱂
鋨	锇
頟	额
額	额
鵝	鹅
鵞	鹅
悪	恶
惡	恶
椏	丫 桠
㩵	擜
啞	哑
埡	垭
堊	垩
戹	厄
搤	扼
蕚	萼
諤	谔
軛	轭
鍔	锷
閼	阏
阨	厄
顎	颚
餓	饿
魥	𩽹
鰐	鳄
鱷	鳄
鶚	鹗
齶	腭
誒	诶
㤙	恩
児	儿
兒	儿
鮞	鲕
鴯	鸸
䋙	䌺
尒	尔
爾	尔
邇	迩
鉺	铒
餌	饵
貳	贰
發	发
醱	酦
栰	筏
罰	罚
罸	罚
閥	阀
灋	法
琺	珐
髮	发
繙	翻
飜	翻
㠶	帆
䋦	𫄩
䫶	𫖺
䮳	𩨏
凢	凡
煩	烦
礬	矾
緐	繁
釩	钒
鐇	𫔍
颿	帆
鷭	𬸪
㼝	碗
氾	泛 氾
汎	泛
範	范
范	范
販	贩
軬	𫐊
飯	饭
鈁	钫
鍅	钫
魴	鲂
鰟	鳑
倣	仿
彷	彷 仿
紡	纺
訪	访
髣	仿
鶭	𫛯
緋	绯
飛	飞
騑	𬴂
鯡	鲱
誹	诽
䉬	𫂈
廢	废
曊	𪰶
櫠	𪲮
疿	痱
癈	废
費	费
鐨	镄
紛	纷
訜	𫍛
鈖	𫟴
雰	氛
墳	坟
幩	𪩸
濆	𣸣
豶	豮
鐼	𫔁
僨	偾
奮	奋
憤	愤
糞	粪
羵	𫅗
膹	𪱥
魵	𫚍
鱝	鲼
丰	丰
偑	㐽
峯	峰
楓	枫
灃	沣
瘋	疯
碸	砜
䗬	蜂
蠭	蜂
諷	讽
豐	丰
鋒	锋
風	风
麷	𫜑
渢	沨
縫	缝
馮	冯
賵	赗
鳳	凤
髴	佛
鴀	𫛜
粰	麸
膚	肤
鈇	𫓧
麩	麸
麬	𤿲
䴸	麸
䋹	䌿
彿	佛
紱	绂
紼	绋
絥	𫄢
縛	缚
輻	辐
錇	锫
韍	韨
鮄	𫚒
鳧	凫
鳬	凫
鴔	𫛡
鵩	𫛳
嘸	呒
撫	抚
輔	辅
頫	俯 𫖯
鯆	𫚙
㵗	𣳆
坿	附
婦	妇
媍	妇
復	复
緮	𫄭
複	复
覆	覆 复
訃	讣
負	负
賦	赋
賻	赙
駙	驸
鮒	鲋
鰒	鳆
嘠	嘎
軋	轧
釓	钆
該	该
賅	赅
隑	𬮿
㮣	概
匃	丐
匄	丐
槩	概
葢	盖
蓋	盖
鈣	钙
乹	干
亁	干
尷	尴
干	干
幹	干
飦	𫗞
桿	杆
稈	秆
贑	赣
趕	赶
鱤	鳡
榦	干
灨	赣
紺	绀
贛	赣
剛	刚
岡	冈
崗	岗
掆	㧏
棡	㭎
疘	肛
碙	𥐻
綱	纲
鋼	钢
戇	戆
槓	杠
槹	槔
皐	皋
臯	皋
餻	糕
攪	搅
暠	皓
稾	稿
縞	缟
鎬	镐
誥	诰
鋯	锆
擱	搁
紇	纥
肐	胳
謌	歌
鎶	鿔
鴿	鸽
嘅	慨
鎘	镉
閣	阁
韚	𫠅
鮯	𫚗
騔	𩨀
魺	鲄
個	个
嗰	𠮶
箇	个
鉻	铬
給	给
䫀	𫖱
亙	亘
揯	搄
畊	耕
絙	𫄠
縆	𬘵
賡	赓
鶊	鹒
綆	绠
頸	颈
骾	鲠
鯁	鲠
恆	恒
𣈶	暅
宮	宫
碽	䂵
篢	𬕂
躳	躬
龔	龚
礦	矿
鞏	巩
摃	扛
貢	贡
溝	沟
緱	缑
鈎	钩
鉤	钩
茍	苟
䝭	𫎧
夠	够
搆	构
構	构
覯	觏
詬	诟
購	购
軲	轱
轂	毂
鈲	𨱃
鈷	钴
鴣	鸪
鶻	鹘
䊺	𫄚
䡩	𫟥
皷	鼓
穀	谷
縎	𦈔
蠱	蛊
詁	诂
谷	谷
賈	贾
餶	馉
鵠	鹄
鼔	鼓
僱	雇
錮	锢
顧	顾
鯝	鲴
刮	刮
煱	㶽
腡	脶
蝸	蜗
颳	刮
騧	䯄
鴰	鸹
剮	剐
𦊱	挂
掛	挂
詿	诖
枴	拐
柺	拐
恠	怪
癐	𤶊
綸	纶
覌	观
観	观
觀	观
関	关
關	关
鰥	鳏
䲘	鳤
筦	管 筦
舘	馆
輨	𫐑
館	馆
慣	惯
摜	掼
貫	贯
鏆	𨱌
鑵	罐
鸛	鹳
輄	𨐈
廣	广
獷	犷
嬀	妫
帰	归
槼	规
歸	归
溈	沩
潙	沩
璝	𪻺
瓌	瑰
規	规
閨	闺
鬹	鬶
鮭	鲑
龜	龟
䞈	𧹑
匭	匦
詭	诡
軌	轨
劊	刽
劌	刿
檜	桧
櫃	柜
襘	𫋻
貴	贵
鱖	鳜
滾	滚
緄	绲
袞	衮
輥	辊
鮌	鲧
鯀	鲧
咼	呙
嘓	啯
堝	埚
渦	涡
濄	㳡
蟈	蝈
過	过
鈛	𫓨
鍋	锅
國	国
幗	帼
摑	掴
漍	𬇹
簂	𫂆
膕	腘
槨	椁
菓	果
錁	锞
餜	馃
鉿	铪
蝦	虾
還	还
頦	颏
駭	骇
頇	顸
魽	𫠐
圅	函
韓	韩
㘚	㘎
闞	阚
扞	捍 扞
漢	汉
猂	悍
釬	焊
銲	焊
閈	闬
頜	颌
頷	颔
馯	𫘛
駻	𫘣
絎	绗
頏	颃
䦳	𨷿
嘷	嗥
獋	嗥
號	号
蠔	蚝
鶴	鹤
灝	灏
皜	皓
顥	颢
訶	诃
合	合
咊	和
盇	盍
覈	核
閡	阂
闔	阖
鶡	鹖
齕	龁
龢	和 龢
嚇	吓
賀	贺
詪	𬣳
䬝	𩙯
橫	横
鴴	鸻
輷	𫐒
轟	轰
閧	哄
魟	𫚉
紅	红
紘	纮
綋	𫟄
葒	荭
訌	讧
鉷	𫟹
鋐	𬭎
閎	闳
鴻	鸿
黌	黉
嗊	唝
鬨	哄
䳧	𫛺
鍭	𬭤
餱	糇
后	后
後	后
鮜	鲘
鱟	鲎
嘑	呼
戯	戏
戲	戏
歘	欻
虖	呼
謼	呼
軤	轷
餬	糊
䊀	糊
壺	壶
衚	胡
鬍	胡
鶘	鹕
鶦	𫛷
乕	虎
滸	浒
許	许
嚛	𪠸
戶	户
沍	冱
滬	沪
護	护
鸌	鹱
嘩	哗
芲	花
鷨	𪉊
㠏	㟆
劃	划
樺	桦
澮	浍
華	华
譁	哗
鏵	铧
驊	骅
㦎	𢛯
䛡	话
划	划
嫿	婳
澅	𣶩
畫	画
畵	画
話	话
諣	𫍩
懐	怀
懷	怀
壊	坏
壞	坏
懽	欢
歡	欢
䝔	獾
讙	欢
貛	獾
驩	欢
鴅	𫛝
䮝	𩧰
環	环
瓛	𤩽
繯	缳
鍰	锾
鐶	镮
闤	阛
澣	浣
緩	缓
喚	唤
奐	奂
換	换
渙	涣
煥	焕
瘓	痪
鯇	鲩
鍠	锽
鐄	𨱑
餭	𫗮
騜	𫘩
鰉	鳇
黃	黄
怳	恍
謊	谎
㨪	晃
噅	𠯠
媈	𫝨
幑	徽
𡽪	徽
揮	挥
撝	㧑
暉	晖
琿	珲
翬	翚
褌	裈
褘	袆
詼	诙
輝	辉
囘	回
回	回
囬	回
廻	回
痐	蛔
蚘	蛔
蛕	蛔
蜖	蛔
迴	回
逥	回
鮰	𫚔
毀	毁
燬	毁
誨	诲
譭	毁
賄	贿
䙡	䙌
匯	汇
噦	哕
嬇	𫝬
彙	汇
會	会
殨	㱮
滙	汇
潰	溃
燴	烩
獩	𤞃
璯	㻅
穢	秽
繐	穗
繢	缋
繪	绘
翽	翙
薈	荟
諱	讳
譓	𬤝
闠	阓
靧	𫖃
頮	颒
昬	昏
葷	荤
閽	阍
㑮	𫝈
䫟	𫖲
䰟	魂
堚	𪣒
渾	浑
餛	馄
餫	𫗥
鯶	𩽼
諢	诨
鈥	钬
伙	伙
夥	伙 夥
㗲	𠵾
彠	彟
旤	祸
楇	𣒌
獲	获
禍	祸
穫	获
貨	货
鑊	镬
騞	𬴃
鱯	鳠
勣	绩 𪟝
嘰	叽
幾	几
擊	击
朞	期
機	机
櫅	𪲎
璣	玑
癘	疠
磯	矶
積	积
緝	缉
績	绩
羇	羁
羈	羁
聻	𫆏
襀	𫌀
覊	羁
譏	讥
賫	赍
賷	赍
跡	迹
蹟	迹
躋	跻
銈	𫓯
隮	𬯀
雞	鸡
飢	饥
饑	饥
鷄	鸡
齎	赍
齏	齑
卽	即
極	极
檝	楫
級	级
藉	藉 借
輯	辑
鈒	钑
鶺	鹡
䍤	𫅅
几	几
擠	挤
濟	济
蟣	虮
魢	鱾
劑	剂
嚌	哜
斉	齐
旣	既
檵	𪲛
済	济
璾	𫞦
紀	纪
繫	系
繼	继
薊	蓟
薺	荠
覬	觊
計	计
記	记
誋	𫍪
際	际
霽	霁
騎	骑
驥	骥
鮆	𫚖
鯽	鲫
鰶	𬶭
鱀	𬶨
鱭	鲚
傢	家
夾	夹
家	家
浹	浃
鎵	镓
鴐	𫛤
䀹	𥅴
戞	戛
挾	挟
梜	𬂩
莢	荚
蛺	蛱
袷	夹 袷
裌	夹
郟	郏
鋏	铗
頰	颊
餄	饸
鵊	𫛥
叚	假 叚
撟	挢
檟	槚
矯	矫
絞	绞
繳	缴
鉀	钾
鉸	铰
餃	饺
價	价
駕	驾
堅	坚
姦	奸
戔	戋
椷	缄
樫	㭴
殲	歼
淺	浅
漸	渐
濺	溅
牋	笺
監	监
箋	笺
籛	篯
緘	缄
縑	缣
艱	艰
蕳	𫈉
鈃	钘
間	间
韉	鞯
騝	𩨃
鰜	鳒
鰹	鲣
鳽	𫛚
鶼	鹣
䅐	𫀨
䛳	𫍫
儉	俭
堿	碱
戩	戬
揀	拣
撿	捡
梘	枧
檢	检
減	减
瞼	睑
礆	硷
筧	笕
簡	简
繭	茧
蠒	茧
襇	裥
謭	谫
錽	𫓸
鐧	锏
鹻	碱
鹼	碱
㔋	𪟎
剣	剑
剱	剑
劍	剑
劎	剑
劒	剑
檻	槛
澗	涧
艦	舰
薦	荐
襉	裥
見	见
諓	𬣡
諫	谏
譖	谮
賤	贱
踐	践
鍳	鉴
鍵	键
鑑	鉴
鑒	鉴
餞	饯
姜	姜
將	将
殭	僵
漿	浆
繮	缰
薑	姜
韁	缰
鱂	鳉
奬	奖
槳	桨
獎	奖
繦	襁
蔣	蒋
講	讲
強	强
彊	强
絳	绛
醬	酱
喬	乔
嬌	娇
澆	浇
膠	胶
蟂	𫋇
鐎	𨱓
驕	骄
鮫	鲛
鵁	䴔
鷦	鹪
䚩	𫌯
僥	侥
儌	侥
斆	敩
腳	脚
蟜	𫊸
譑	𫍤
較	较
呌	叫
嶠	峤
敎	教
覺	觉
轎	轿
啑	喋
堦	阶
癤	疖
稭	秸
節	节
結	结
階	阶
㨗	捷
䌖	𦈜
傑	杰
刦	劫
刧	劫
刼	劫
擷	撷
潔	洁
絜	洁 絜
訐	讦
詰	诘
頡	颉
鮚	鲒
借	借
屆	届
誡	诫
紟	𫄛
觔	斤
釒	钅
僅	仅
儘	尽
厪	廑
巹	卺
盡	尽
𦂳	紧
𦃂	紧
緊	紧
覲	觐
謹	谨
錦	锦
饉	馑
䌝	𦈟
䫴	𩖗
勁	劲
唫	吟
晉	晋
濜	浕
燼	烬
璡	琎
縉	缙
藎	荩
贐	赆
進	进
鋟	锓
涇	泾
秔	粳
稉	粳
経	经
經	经
荊	荆
莖	茎
驚	惊
鯨	鲸
鶄	䴖
剄	刭
烴	烃
穽	阱
㵾	𪷍
俓	𠇹
凈	净
弳	弪
徑	径
桱	𣐕
淨	净
痙	痉
競	竞
脛	胫
葝	𫈎
踁	胫
逕	径 迳
鏡	镜
靚	靓
靜	静
絅	䌹
駉	𬳶
駫	𫘡
烱	炯
熲	颎
逈	迥
揫	揪
糾	纠
轇	𫐖
鬮	阄
鳩	鸠
韮	韭
倃	咱
廄	厩
廐	厩
捄	救
舊	旧
鷲	鹫
據	据
輋	𪨶
鋦	锔
鋸	锯
駒	驹
鮈	𬶋
侷	局
跼	局
駶	𩧺
鶪	䴗
擧	举
榘	矩
櫸	榉
欅	榉
舉	举
齟	龃
㨿	据
冣	最
劇	剧
寠	𪧘
屨	屦
懼	惧
据	据
窶	窭
詎	讵
貗	𫎌
鉅	巨 钜
颶	飓
𩗗	飓
鮍	鲏
勌	倦
鎸	镌
鐫	镌
鵑	鹃
卷	卷
捲	卷
錈	锩
儁	俊
劵	券
獧	狷
睠	眷
絹	绢
雋	隽
鞽	鞒
𩭪	䘿
屩	𪨗
撧	𪮖
斍	觉
橜	橛
決	决
絕	绝
絶	绝
蕝	𫈵
訣	诀
譎	谲
鐍	𫔎
鐝	镢
钁	镢 䦆
鱊	𫚪
鴃	𫛞
皸	皲
軍	军
鈞	钧
銁	𫓲
頵	𫖳
鮶	鲪
㑺	俊
攟	捃
濬	浚
餕	馂
駿	骏
鐦	锎
開	开
凱	凯
剴	剀
塏	垲
愷	恺
豈	岂
鍇	锴
鎧	铠
闓	闿
愾	忾
欬	咳
栞	刊
龕	龛
偘	侃
埳	坎
轗	𫐘
矙	瞰
穅	糠
閌	闶
鱇	𩾌
匟	炕
鈧	钪
攷	考
槀	槁
鮳	鲓
銬	铐
軻	轲
鈳	钶
顆	颗
殻	壳
殼	壳
克	克
剋	克 剋
緙	缂
課	课
騍	骒
墾	垦
懇	恳
肎	肯
齗	龂
齦	龈
娙	𫰛
硜	硁
鏗	铿
阬	坑
剾	𠛅
彄	𫸩
摳	抠
瞘	眍
𭁵	寇
𡨥	寇
敂	叩
釦	扣
嚳	喾
庫	库
絝	绔
袴	裤
褲	裤
𧥢	夸
夸	夸
誇	夸
喎	㖞
擓	㧟
䯤	𩩈
儈	侩
噲	哙
塊	块
獪	狯
膾	脍
鄶	郐
駃	𫘝
鬠	𫘽
鱠	鲙
寛	宽
寬	宽
臗	𣎑
髖	髋
䥗	𫔋
欵	款
誆	诓
誑	诳
鵟	𫛭
儣	𠆲
壙	圹
曠	旷
況	况
纊	纩
貺	贶
鄺	邝
鑛	矿
巋	岿
窺	窥
虧	亏
闚	窥
䳫	𫛼
騤	骙
頍	𫠆
匱	匮
嘳	𪡞
媿	愧
憒	愦
槶	椢
瞶	瞆
簀	箦
簣	篑
聵	聩
蕢	蒉
謉	𫍷
餽	馈
饋	馈
堃	坤 堃
崐	昆
崑	昆
瑻	𪻲
錕	锟
騉	𫘥
鯤	鲲
鵾	鹍
壼	壸
綑	捆
閫	阃
困	困
睏	困
𢬸	括
擴	扩
濶	阔
適	适
闊	阔
攋	𪮶
臈	腊
臘	腊
蠟	蜡
辢	辣
鑞	镴
鯻	𬶟
來	来
倈	俫
婡	𫝫
崍	崃
徠	徕
棶	梾
淶	涞
萊	莱
錸	铼
麳	𪎌
㠣	𫵷
瀨	濑
癩	癞
睞	睐
籟	籁
襰	𧝝
賚	赉
賴	赖
頼	赖
顂	𩓋
㘓	𪢌
囒	𪢠
嵐	岚
攔	拦
斕	斓
欄	栏
瀾	澜
灡	㳕
璼	𫞨
籃	篮
繿	䍀
藍	蓝
蘭	兰
襤	褴
襴	襕
讕	谰
躝	𨅬
鑭	镧
闌	阑
㩜	㨫
壈	𡒄
嬾	懒
孄	𫝮
懶	懒
攬	揽
欖	榄
纜	缆
覧	览
覽	览
濫	滥
爛	烂
瑯	琅
蜋	螂
鋃	锒
閬	阆
撈	捞
勞	劳
嘮	唠
嶗	崂
澇	涝
癆	痨
鐒	铹
銠	铑
橯	𣓿
絡	络
耮	耢
樂	乐
鰳	鳓
了	了
餎	饹
縲	缧
纍	累
轠	𫐙
鐳	镭
壘	垒
虆	蔂
誄	诔
淚	泪
累	累
纇	颣
類	类
稜	棱
蔆	菱
䍦	䍠
孋	㛤
棃	梨
氂	牦
漓	漓
灕	漓
犂	犁
犛	牦
瓈	璃
篱	篱
籬	篱
縭	缡
蔾	藜
蘺	蓠
褵	缡
貍	狸
釃	酾
離	离
驪	骊
鯬	𫚞
鱺	鲡
鸝	鹂
麗	丽
禮	礼
裏	里
裡	里
邐	逦
里	里
鋰	锂
鯉	鲤
鱧	鳢
㯤	𣘐
䁻	䀥
䍽	𦍠
䟐	𫎱
𩶘	䲞
儷	俪
勵	励
𠪱	历
厤	历
厲	厉
嚦	呖
壢	坜
慄	栗
擽	㧰
曆	历
櫟	栎
櫪	枥
欐	𪲔
歴	历
歷	历
涖	莅
濿	𪵱
瀝	沥
爄	𤇃
琍	璃
瓅	𬍛
癧	疬
礪	砺
礫	砾
糲	粝
綟	𫄫
茘	荔
蒞	莅
藶	苈
蘚	藓
蠣	蛎
躒	跞
轢	轹
轣	𫐆
酈	郦
釙	钋
鉝	𫟷
𨽻	隶
隷	隶
隸	隶
靂	雳
鴗	𫁡
鷅	𫛽
倆	俩
㢘	廉
䥥	镰
䭑	𫗱
亷	廉
匲	奁
匳	奁
嗹	𪡏
奩	奁
帘	帘
憐	怜
槤	梿
漣	涟
璉	琏
簾	帘
籨	奁
縺	𦈐
聯	联
蓮	莲
褳	裢
連	连
鎌	镰
鐮	镰
鰱	鲢
斂	敛
臉	脸
蘞	蔹
襝	裣
孌	娈
戀	恋
歛	敛
殮	殓
瀲	潋
煉	炼
練	练
薟	莶
鏈	链
鰊	𬶠
𩞯	䭪
樑	梁
涼	凉
糧	粮
綡	𫟅
輬	辌
䓣	𬜯
兩	两
啢	唡
掚	𪭵
魎	魉
諒	谅
輛	辆
鍄	𨱉
療	疗
繚	缭
遼	辽
鐐	镣
鷚	鹨
鷯	鹩
瞭	瞭 了
釕	钌
獵	猎
鮤	𫚓
鱲	𫚭
鴷	䴕
壣	𪤚
惏	婪
燐	磷
痳	淋
粦	磷
臨	临
轔	辚
鄰	邻
鏻	𬭸
隣	邻
驎	𬴊
鱗	鳞
麐	麟
凜	凛
廩	廪
懍	懔
檁	檩
綝	𬘭
恡	吝
藺	蔺
賃	赁
躪	躏
閵	𫔴
𤫩	㻏
䖅	𫟑
櫺	棂
欞	棂
淩	凌
爧	𫞠
綾	绫
軨	𫐉
鈴	铃
錂	𨱋
閝	𫠂
霛	灵
靈	灵
鯪	鲮
鴒	鸰
齡	龄
嶺	岭
領	领
㽞	留
劉	刘
瀏	浏
瑠	琉
璢	琉
畄	留
𤱊	留
畱	留
癅	瘤
鎦	镏
鏐	镠
飀	飗
餾	馏
騮	骝
鶹	鹠
栁	柳
桺	柳
綹	绺
鉚	铆
鋶	锍
畂	亩
陸	陆
霤	溜
䪊	𫖅
嚨	咙
曨	昽
朧	胧
櫳	栊
瀧	泷
爖	𤇭
瓏	珑
矓	眬
礱	砻
籠	笼
聾	聋
蘢	茏
躘	𨀁
鸗	𫛟
龍	龙
龓	𫜲
壟	垄
壠	垄
攏	拢
隴	陇
徿	𪫌
挵	弄
衖	弄
贚	𫎦
摟	搂
㟺	𪩇
㺏	𤠋
䮫	𩨇
僂	偻
嘍	喽
婁	娄
樓	楼
漊	溇
熡	𤋏
瞜	䁖
耬	耧
蔞	蒌
螻	蝼
謱	𫍴
遱	𫐷
髏	髅
塿	𪣻
嶁	嵝
簍	篓
瘺	瘘
瘻	瘘
鏤	镂
嚕	噜
擼	撸
㿖	𪽮
嚧	𠰷
壚	垆
廬	庐
曥	𣆐
櫨	栌
瀘	泸
爐	炉
盧	卢
矑	𪾦
臚	胪
艫	舻
蘆	芦
蠦	𫊮
轤	轳
鑪	炉 𬬻
顱	颅
鱸	鲈
鸕	鸬
㯭	橹
擄	掳
樐	橹
櫓	橹
氌	氇
滷	卤
瀂	澛
磠	硵
艣	橹
艪	橹
虜	虏
鐪	𫓺
鑥	镥
魯	鲁
鹵	卤
剹	戮
彔	录
淥	渌
磟	碌
祿	禄
籙	箓
菉	绿 菉
賂	赂
輅	辂
轆	辘
錄	录
録	录
騄	𫘧
騼	𫠋
鷺	鹭
圞	𪢮
孿	孪
巒	峦
攣	挛
欒	栾
灤	滦
臠	脔
鑾	銮
鵉	鸾
鸞	鸾
亂	乱
畧	略
鋝	锊
掄	抡
㖮	𪠵
㷍	𤆢
侖	仑
倫	伦
圇	囵
崘	仑
崙	仑
淪	沦
菕	𰰨
論	论
輪	轮
錀	𬬭
埨	𫭢
囉	啰
羅	罗
儸	㑩
欏	椤
玀	猡
籮	箩
蘿	萝
覼	𫌨
邏	逻
鏍	镙
鑼	锣
饠	𫗩
騾	骡
驘	骡
臝	裸
躶	裸
鎯	𨱍
濼	泺
犖	荦
駱	骆
慺	㥪
櫚	榈
膢	𦝼
閭	闾
馿	驴
驢	驴
侶	侣
呂	吕
屢	屡
穭	穞
縷	缕
褸	褛
鋁	铝
慮	虑
濾	滤
綠	绿
緑	绿
嗎	吗
媽	妈
嬤	嬷
蔴	麻
螞	蚂
蟇	蟆
麼	么 麽
嘜	唛
獁	犸
瑪	玛
碼	码
鎷	𨰾
馬	马
榪	杩
禡	祃
罵	骂
駡	骂
嘪	𪡃
蕒	荬
買	买
䘑	脉
勱	劢
脈	脉
賣	卖
邁	迈
麥	麦
顢	颟
璊	𫞩
瞞	瞒
蠻	蛮
謾	谩
蹣	蹒
饅	馒
鰻	鳗
満	满
滿	满
蟎	螨
澫	𬇕
縵	缦
蔄	𬜬
鏝	镘
鋩	铓
莾	莽
蠎	蟒
貓	猫
錨	锚
夘	卯
戼	卯
㡌	帽
䋃	𫄜
冐	冒
貿	贸
楳	梅
槑	梅
沒	没
鋂	𰾄
鎇	镅
鶥	鹛
黴	霉
鎂	镁
謎	谜
悶	闷
們	们
捫	扪
樠	𣗊
鍆	钔
門	门
懣	懑
燜	焖
濛	蒙
矇	蒙
蝱	虻
鄳	𫑡
鸏	鹲
懞	蒙
蒙	蒙
錳	锰
夢	梦
夣	梦
瞇	眯
㜷	𡝠
𡾱	㟜
䕳	𦰴
䪾	𫖬
彌	弥
擟	𪭧
瀰	弥
獼	猕
瓕	𤦀
禰	祢
籋	𥬞
羋	芈
冪	幂
祕	秘 祕
覓	觅
覔	觅
謐	谧
綿	绵
緜	绵
俛	俯 俛
澠	渑
緬	缅
靦	腼 䩄
鮸	𩾃
麫	面
黽	黾
面	面
靣	面
麪	面
麵	面
鶓	鹋
淼	渺 淼
𣺌	渺
𦕈	眇
緲	缈
廟	庙
玅	妙
繆	缪
𠴟	咩
滅	灭
烕	灭
蔑	蔑
衊	蔑
緍	𦈏
緡	缗
冺	泯
憫	悯
潣	𫞗
閔	闵
閩	闽
鰵	鳘
㝠	冥
𠖇	冥
銘	铭
鳴	鸣
𠇮	命
謬	谬
䉑	𫁲
橅	模
無	无
謨	谟
饃	馍
饝	馍
麽	么 麽
歿	殁
縸	𫄲
纆	𬙊
萬	万
衇	脉
覛	𫌪
謩	谟
鏌	镆
霢	霡
驀	蓦
謀	谋
鉾	𫓴
墲	𪢸
𤰜	亩
𤱈	亩
畆	亩
畝	亩
畮	亩
鉧	𬭁
幙	幕
樢	㭤
鉬	钼
鶩	鹜
拏	拿
挐	拿
鎿	镎
䪏	𩏼
吶	呐
納	纳
訥	讷
軜	𫐇
鈉	钠
孻	𡥧
妳	奶 你
嬭	奶
廼	乃
迺	乃 迺
錼	镎
䶲	𫜳
枏	楠
柟	楠
難	难
䁪	𥇢
憹	𢙐
饢	馕
撓	挠
橈	桡
繷	𫄣
蟯	蛲
譊	𫍢
鐃	铙
䜀	䜧
堖	垴
惱	恼
腦	脑
閙	闹
鬧	闹
餒	馁
內	内
嫰	嫩
薴	苧
濘	泞
蜺	霓
輗	𫐐
鈮	铌
鯢	鲵
齯	𫠜
儗	拟
擬	拟
暱	昵
膩	腻
鷊	鹝
秊	年
鮎	鲇
鯰	鲶
攆	撵
躎	䟢
輦	辇
唸	念
孃	娘
釀	酿
嫋	袅
嬝	袅
蔦	茑
𡡅	袅
裊	袅
褭	袅
鳥	鸟
揑	捏
䯀	䯅
嚙	啮
囁	嗫
囓	啮
孼	孽
櫱	蘖
湼	涅
聶	聂
躡	蹑
錜	𫓻
鎳	镍
鑷	镊
闑	𫔶
隉	陧
顳	颞
齧	啮
䋻	䌾
䗿	𧉞
嚀	咛
嬣	𪥰
寕	宁
寜	宁
寧	宁
擰	拧
檸	柠
獰	狞
甯	宁 甯
聹	聍
苧	苎
鸋	𫛢
侫	佞
紐	纽
鈕	钮
燶	㶶
儂	侬
噥	哝
濃	浓
穠	秾
膿	脓
蕽	𫇽
農	农
辳	农
醲	𬪩
譨	𫍦
駑	驽
㬉	暖
煖	暖
煗	暖
餪	𫗬
瘧	疟
謔	谑
㰙	𣗙
儺	傩
稬	糯
穤	糯
諾	诺
鍩	锘
釹	钕
䶊	衄
衂	衄
區	区
嘔	呕
塸	𫭟
慪	怄
歐	欧
毆	殴
漚	沤
熰	𬉼
甌	瓯
謳	讴
鷗	鸥
䶕	𫜨
盤	盘
踫	碰
詊	𫟟
䮾	𩧪
龎	庞
龐	庞
拋	抛
皰	疱
砲	炮
礟	炮
肧	胚
裵	裴
賠	赔
浿	𬇙
轡	辔
噴	喷
亯	享
塜	冢
鵬	鹏
掽	碰
紕	纰
鈹	铍
駓	𬳵
毘	毗
疋	匹
鷿	𬸯
鸊	䴙
諞	谝
駢	骈
騙	骗
縹	缥
飃	飘
飄	飘
朴	朴
䥕	𬭯
嬪	嫔
蘋	苹 𬞟
貧	贫
頻	频
顰	颦
凴	凭
憑	凭
缾	瓶
評	评
軿	𫐌
鮃	鲆
潑	泼
鉕	钷
鏺	䥽
頗	颇
廹	迫
仆	仆
僕	仆
撲	扑
鋪	铺
樸	朴
轐	𫐗
鏷	镤
譜	谱
鐠	镨
舖	铺
悽	凄
慼	戚
慽	戚
棲	栖
榿	桤
淒	凄
谿	溪 谿
顣	𫖹
鸂	㶉
䳢	𫛰
亝	斋
旂	旗
棊	棋
碁	棋
碕	埼
祇	只 祇
竢	俟
臍	脐
蘄	蕲
蠐	蛴
衹	只
軝	𬨂
錡	锜
錤	𫓹
頎	颀
騏	骐
鯕	鲯
鰭	鳍
齊	齐
唘	启
啓	启
啟	启
綺	绮
𨊰	䢀
憇	憩
棄	弃
氣	气
磧	碛
訖	讫
鏚	𬭭
僉	佥
千	千
慳	悭
牽	牵
簽	签
籤	签
縴	纤
羥	羟
諐	愆
謙	谦
遷	迁
釺	钎
鉛	铅
韆	千
顅	𫖶
騫	骞
鵮	鹐
乾	干 乾
潛	潜
蕁	荨
鈐	钤
鉗	钳
銭	钱
錢	钱
騚	𩨊
繾	缱
譴	谴
塹	堑
槧	椠
綪	𬘬
嗆	呛
嶈	𡺃
槍	枪
瑲	玱
𦍑	羌
羗	羌
蹌	跄
錆	锖
鎗	枪
鏘	锵
鏹	镪
墻	墙
嬙	嫱
廧	𪪞
檣	樯
牆	墙
艢	樯
薔	蔷
熗	炝
磽	硗
繰	缲
蹺	跷
鍫	锹
鍬	锹
䀉	𥁢
䱁	𫚏
僑	侨
嘺	𪡀
橋	桥
癄	憔
礄	硚
翹	翘
蕎	荞
譙	谯
鐈	𫓱
顦	憔
鵲	鹊
㢗	𪪑
竅	窍
誚	诮
陗	峭
㥦	惬
愜	惬
竊	窃
篋	箧
鍥	锲
嶔	嵚
欽	钦
親	亲
駸	骎
懃	勤
琹	琴
寑	寝
寢	寝
搇	揿
撳	揿
傾	倾
氫	氢
軽	轻
輕	轻
頃	顷
鯖	鲭
䝼	䞍
廎	庼
請	请
慶	庆
煢	茕
瓊	琼
窮	穷
笻	筇
藭	䓖
坵	丘
𥤚	秋
秌	秋
鞦	秋
鰍	鳅
鶖	鹙
巰	巯
毬	球
虯	虬
賕	赇
釚	𫟲
銶	𨱇
鯄	𩾁
鰽	𫚧
嶇	岖
敺	驱
覷	觑
誳	𫍮
軀	躯
駈	驱
驅	驱
鶌	𫛵
麯	曲
麴	曲 麹
鴝	鸲
曲	曲
詓	𫍜
齲	龋
闃	阒
權	权
詮	诠
輇	辁
銓	铨
顴	颧
駩	𩧴
鰁	鳈
綣	绻
勸	劝
闕	阙
㕁	却
卻	却
愨	悫
慤	悫
搉	榷
𣙜	榷
灍	𫞝
確	确
礐	𬒈
闋	阕
帬	裙
羣	群
裠	裙
髥	髯
冄	冉
譲	让
讓	让
嬈	娆
蕘	荛
襓	𫋹
饒	饶
擾	扰
繞	绕
遶	绕
熱	热
䭃	𩠈
姙	妊
紉	纫
紝	纴
絍	𫟃
袵	衽
訒	讱
認	认
軔	轫
靭	韧
靱	韧
韌	韧
飪	饪
餁	饪
馹	驲
嶸	嵘
榮	荣
毧	绒
爃	𫞡
絨	绒
羢	绒
螎	融
蠑	蝾
鎔	镕
鰫	𫚦
宂	冗
輮	𫐓
鍒	𫔄
銣	铷
顬	颥
鴽	𫛪
縟	缛
蝡	蠕
軟	软
輭	软
橤	蕊 橤
蕋	蕊
蘂	蕊
叡	睿
銳	锐
鋭	锐
瞤	𥆧
潤	润
閏	闰
篛	箬
灑	洒
䬃	飒
薩	萨
颯	飒
顋	腮
鰓	鳃
賽	赛
𣯶	毵
毿	毵
𠌂	伞
傘	伞
糝	糁
繖	伞
鏾	𫔌
饊	馓
㪚	散
閐	𨸃
喪	丧
桒	桑
顙	颡
繅	缫
颾	𩙫
騷	骚
鰠	鳋
鱢	𫚫
掃	扫
嗇	啬
懎	𢠁
澀	涩
澁	涩
濇	涩
犞	𪺭
穡	穑
繬	𫄱
譅	𰶎
銫	铯
飋	𫗋
幓	㡎
槮	椮
篸	𥮾
蔘	参
摋	𢫬
樧	榝
殺	杀
紗	纱
鎩	铩
魦	𫚌
鯊	鲨
廈	厦
篩	筛
曬	晒
刪	删
姍	姗
穇	䅟
羴	膻
羶	膻
軕	𫐅
釤	钐
㪎	𪯋
熌	𤇄
睒	䀹
閃	闪
陝	陕
陿	狭
䥇	䦂
墠	𫮃
繕	缮
訕	讪
謆	𫍸
贍	赡
銏	𫟶
鐥	䦅
饍	膳
騸	骟
鱓	鳝
鱔	鳝
傷	伤
殤	殇
湯	汤
觴	觞
賞	赏
緔	绱
燒	烧
䈰	筲
紹	绍
賒	赊
𧵳	䞌
虵	蛇
鉈	铊
捨	舍
䌰	𦈙
䠶	射
厙	厍
懾	慑
攝	摄
欇	𪳍
灄	滠
舍	舍
葉	叶
設	设
誰	谁
㴱	深
紳	绅
葠	参
詵	诜
鉮	𬬹
駪	𬳽
嬸	婶
審	审
沈	沈
瀋	沈
諗	谂
讅	谉
昚	慎
滲	渗
瘮	瘆
腎	肾
鋠	𫓵
昇	升 昇
聲	声
陞	升 陞
繩	绳
勝	胜
聖	圣
賸	剩
噓	嘘
屍	尸
師	师
溮	浉
溼	湿
濕	湿
獅	狮
絁	𫄟
蝨	虱
螄	蛳
詩	诗
鯴	鲺
鰤	𫚕
鳲	鸤
鳾	䴓
塒	埘
寔	实
實	实
旹	时
時	时
溡	𪶄
碩	硕
蒔	莳
蝕	蚀
識	识
飠	饣
鰣	鲥
駛	驶
佀	似
勢	势
弒	弑
昰	是
柹	柿
眎	视
視	视
試	试
諟	𬤊
諡	谥
謚	谥
貰	贳
軾	轼
釋	释
鈰	铈
鉽	𫟸
飾	饰
荍	荞
壽	寿
獸	兽
綬	绶
鏉	𨱒
倐	倏
攄	摅
書	书
樞	枢
疎	疏
紓	纾
綀	𦈌
踈	疏
軗	𨐅
輸	输
贖	赎
䠱	𨅛
屬	属
數	数
藷	薯
㜐	𫝧
儵	倏
庻	庶
术	术
樹	树
潄	漱
竪	竖
術	术
豎	竖
鉥	𬬸
縗	缞
帥	帅
繂	𫄴
閂	闩
㕠	双
孇	𪥫
雙	双
驦	骦
鸘	鹴
騻	𫘭
挩	捝
涗	涚
稅	税
蛻	蜕
說	说
説	说
賰	䞐
順	顺
爍	烁
鎙	𫔈
鑠	铄
俬	私
噝	咝
廝	厮
糹	纟
絲	丝
緦	缌
鍶	锶
颸	飔
鷥	鸶
瀃	𣽷
禩	祀
釲	𫟳
飤	饲
飼	饲
駟	驷
松	松
枩	松
鬆	松
㩳	㧐
慫	怂
聳	耸
訟	讼
誦	诵
頌	颂
餸	𩠌
鎪	锼
颼	飕
餿	馊
騪	𩨄
擻	擞
籔	䉤
藪	薮
謏	𫍲
𠻳	嗽
囌	苏
甦	苏 甦
穌	稣
蘇	苏
蘓	苏
㝛	宿
㩋	𪮋
愬	诉
泝	溯
潚	㴋
縮	缩
肅	肃
訴	诉
謖	谡
遡	溯
鋉	𨱈
餗	𫗧
驌	骕
鷫	鹔
痠	酸
綏	绥
雖	虽
隨	随
䡵	𫟦
𡻕	岁
嵗	岁
歲	岁
繸	䍁
誶	谇
鐩	𬭼
孫	孙
猻	狲
蓀	荪
飱	飧
損	损
筍	笋
愻	𢙏
挱	挲
簑	蓑
嗩	唢
𤨏	琐
瑣	琐
鎍	𫔅
鎖	锁
鎻	锁
牠	它
獺	獭
鰨	鳎
㒓	𠉂
䌈	𦈖
搨	拓
撻	挞
澾	㳠
躂	跶
鑉	𫠁
闥	闼
臺	台
台	台
檯	台
薹	苔 薹
颱	台
駘	骀
鮐	鲐
態	态
鈦	钛
攤	摊
灘	滩
癱	瘫
貪	贪
墰	坛
壇	坛
壜	坛
曇	昙
罈	坛
罎	坛
談	谈
譚	谭
錟	锬
鷤	𫛴
襢	袒
贉	𫎫
鉭	钽
䜖	𫟢
嘆	叹
歎	叹
賧	赕
劏	㓥
鏜	镗
鐋	铴
醣	糖
餳	饧
餹	糖
儻	傥
鎲	镋
钂	镋
燙	烫
搯	掏
絛	绦
縚	绦
縧	绦
謟	谄
韜	韬
䬞	𩙧
檮	梼
綯	绹
騊	𫘦
討	讨
蟘	𫋌
鋱	铽
籐	藤
謄	誊
騰	腾
鰧	䲢
銻	锑
鷉	䴘
嗁	啼
穉	稚
綈	绨
緹	缇
蹏	蹄
題	题
騠	𫘨
鯷	鳀
鵜	鹈
鶗	𫛸
體	体
屜	屉
殢	𣨼
薙	剃
錫	锡
鬀	剃
靝	靔
闐	阗
覥	觍
賟	𧹖
鮡	𬶐
條	条
樤	𣔌
鰷	鲦
齠	龆
糶	粜
覜	眺
貼	贴
鉄	铁
鐵	铁
䴴	𪎋
厛	厅
廰	厅
廳	厅
聴	听
聼	听
聽	听
綎	𬘩
䋼	𫄮
頲	颋
痌	恫
仝	同 仝
絧	𫄡
詷	𫍣
銅	铜
鮦	鲖
筩	筒
統	统
慟	恸
衕	同
媮	偷
鍮	𨱎
頭	头
鈄	钭
禿	秃
鵚	𪉍
䳜	𫛬
圖	图
塗	涂
涂	涂
鈯	𨱄
駼	𬳿
釷	钍
兎	兔
團	团
摶	抟
槫	𣏢
糰	团
㿗	𤻊
𥢢	䅪
穨	颓
隤	𬯎
頹	颓
頽	颓
骽	腿
臋	臀
飩	饨
魨	鲀
拕	拖
脫	脱
託	托
詑	𫍡
䡐	𫟤
䭾	驮
䴱	𫜒
飥	饦
駝	驼
鮀	𬶍
鴕	鸵
鼉	鼍
橢	椭
籜	箨
蘀	萚
媧	娲
漥	洼
窪	洼
鼃	蛙
膃	腽
襪	袜
韈	袜
韤	袜
壪	塆
彎	弯
灣	湾
紈	纨
頑	顽
椀	碗 椀
盌	碗
綰	绾
輓	挽
䥑	鿏
万	万
綄	𬘫
翫	玩
贃	𧹗
尫	尪
亾	亡
徃	往
瀇	㲿
網	网
㒺	罔
誷	𫍬
輞	辋
朢	望
鰃	鳂
䥩	𨱖
圍	围
幃	帏
湋	𣲗
潿	涠
濰	潍
爲	为
維	维
覹	𫌭
違	违
闈	闱
韋	韦
鮠	𬶏
䪘	𩏿
偉	伟
暐	𬀩
椲	㭏
煒	炜
瑋	玮
緯	纬
葦	苇
蔿	𫇭
薳	䓕
蘤	花
諉	诿
韙	韪
頠	𬱟
鮪	鲔
䲁	鳚
䵳	𪑅
偽	伪
僞	伪
懀	𢙓
磑	硙
蝟	猬
衛	卫
衞	卫
謂	谓
轊	𫐕
遺	遗
鏏	𬭬
餵	喂
溫	温
緼	缊
輼	辒
轀	辒
鰛	鳁
鰮	鳁
紋	纹
聞	闻
螡	蚊
蟁	蚊
閿	阌
馼	𫘜
鳼	𪉃
穏	稳
穩	稳
脗	吻
問	问
搵	揾
熓	𤆡
鎓	𬭩
鶲	鹟
甕	瓮
罋	瓮
撾	挝
窩	窝
萵	莴
臥	卧
齷	龌
嗚	呜
汙	污
汚	污
烏	乌
誣	诬
鄔	邬
鎢	钨
鴮	𫛦
吳	吴
蕪	芜
鋙	铻
鵐	鹀
啎	忤
嫵	妩
廡	庑
憮	怃
潕	𣲘
鵡	鹉
務	务
噁	恶 𫫇
塢	坞
悞	误
誤	误
軏	𫐄
隖	坞
霧	雾
騖	骛
厀	膝
晳	晰
熈	熙
𤋮	熙
犧	牺
鑴	𫔔
騱	𫘬
驨	𫘱
㩗	携
習	习
蓆	席
襲	袭
覡	觋
鰼	鳛
璽	玺
縰	𫄳
纚	𫄥
諰	𫍰
銑	铣
霼	𪵣
鱚	𬶮
㑶	㐹
係	系
屓	屃
屭	屃
戱	戏
熂	𪸕
系	系
細	细
綌	绤
釳	𨰿
餼	饩
鬩	阋
鰕	𫚥
䪗	𩐀
俠	侠
峽	峡
狹	狭
硤	硖
轄	辖
㗿	𪡛
欱	喝
僊	仙
憸	𪫺
秈	籼
纖	纤
躚	跹
銛	铦
鍁	锨
鮮	鲜
鱻	鲜
㳄	涎
咸	咸
啣	衔
嫺	娴
嫻	娴
撏	挦
癇	痫
絃	弦
衘	衔
諴	𫍯
賢	贤
銜	衔
閑	闲
鷳	鹇
鷴	鹇
鹹	咸
尟	鲜
尠	鲜
嶮	崄
獫	猃
獮	狝
玁	𤞤
癬	癣
蜆	蚬
險	险
顕	显
顯	显
齴	𫜮
俔	伣
哯	𠯟
峴	岘
憲	宪
撊	𪭾
晛	𬀪
獻	献
現	现
睍	𪾢
綫	线
線	线 缐
縣	县
羨	羡
莧	苋
餡	馅
麲	𪎉
廂	厢
緗	缃
纕	𬙋
薌	芗
鄉	乡
鑲	镶
驤	骧
詳	详
響	响
餉	饷
饗	飨
鮝	鲞
鯗	鲞
向	向
嚮	向
曏	向
蠁	蚃
項	项
嘵	哓
憢	𢙒
梟	枭
毊	𪵑
瀟	潇
簫	箫
綃	绡
蕭	萧
蠨	蟏
銷	销
驍	骁
鴞	鸮
曉	晓
篠	筱
傚	效
効	效
咲	笑
嘯	啸
斅	𢽾
蠍	蝎
㩦	携
協	协
擕	携
攜	携
纈	缬
脅	胁
脇	胁
脥	𣍰
衺	邪
諧	谐
鞵	鞋
䥱	䥾
冩	写
寫	写
蠏	蟹
𧜵	䙊
洩	泄
瀉	泻
爕	燮
紲	绁
絏	绁
緤	𫄬
缷	卸
褻	亵
謝	谢
齘	𬹼
廞	𫷷
鋅	锌
尋	寻
樳	桪
鄩	𬩽
釁	衅
興	兴
騂	骍
滎	荥
濚	溁
鉶	铏
陘	陉
倖	幸
兇	凶
洶	汹
胷	胸
訩	讻
詗	诇
潃	滫
脩	修 脩
饈	馐
鵂	鸺
綇	𦈋
綉	绣
繡	绣
銹	锈
鏥	𫔊
鏽	锈
吁	吁
嬃	媭
籲	吁
繻	𦈡
虛	虚
訏	𬣙
須	须
頊	顼
鬚	须
㑯	㑔
盨	𪾔
詡	诩
諝	谞
䘏	恤
勗	勖
卹	恤
壻	婿
敍	叙
敘	叙
朂	勖
漵	溆
緒	绪
續	续
賉	恤
銊	𫓰
鱮	𫚈
塤	埙
萲	萱
蕿	萱
藼	萱
蘐	萱
諠	喧
諼	谖
譞	𫍽
軒	轩
鋗	𫓶
鶱	𬸣
䮄	𫠊
䴉	鹮
䴋	𫜅
懸	悬
旋	旋
選	选
楥	楦
絢	绚
繏	𦈝
鉉	铉
鏇	旋
嶨	峃
䫻	𫗇
學	学
斈	学
澩	泶
鷽	鸴
鱈	鳕
勛	勋
勲	勋
勳	勋
壎	埙
燻	熏
纁	𫄸
㜄	㚯
噚	㖊
𡬶	寻
廵	巡
潯	浔
燖	𬊈
璕	𬍤
紃	𬘓
蟳	𫊻
詢	询
馴	驯
鱘	鲟
䭀	𩠇
狥	徇
訊	讯
訓	训
遜	逊
壓	压
鴉	鸦
鴨	鸭
鵶	鸦
崕	崖
枒	丫
亞	亚
掗	挜
瘂	痖
婭	娅
氬	氩
稏	䅉
訝	讶
錏	铔
齾	𫜰
厭	厌
煙	烟
臙	胭
菸	烟
醃	腌
閹	阉
厳	严
嚴	严
塩	盐
嵒	岩
巌	岩
巖	岩
巗	岩
簷	檐
綖	𫄧
訁	讠
閆	闫
閻	阎
顃	𩖖
顏	颜
顔	颜
鹽	盐
儼	俨
兗	兖
厴	厣
巘	𪩘
揜	掩
魘	魇
鰋	𫚢
鶠	𬸘
黶	黡
鼴	鼹
龑	䶮
噞	𪡋
嚥	咽
彥	彦
灎	滟
灧	滟
灩	滟
燄	焰
硯	砚
艶	艳
艷	艳
覎	觃
諺	谚
讌	宴
讞	谳
豓	艳
豔	艳
贋	赝
贗	赝
醶	𫑷
醼	宴
釅	酽
饜	餍
騐	验
騴	𫘫
驗	验
鴈	雁
鴳	𫛩
鷰	燕
鉠	𫓭
鴦	鸯
揚	扬
敭	扬
暘	旸
楊	杨
煬	炀
瑒	玚
瘍	疡
鍚	钖
陽	阳
颺	扬 飏
鰑	𫚊
癢	痒
養	养
駚	𩧫
樣	样
約	约
訞	𫍚
堯	尧
嶢	峣
搖	摇
殽	淆
瑤	瑶
窯	窑
窰	窑
謠	谣
謡	谣
軺	轺
遙	遥
颻	飖
餚	肴
鰩	鳐
殀	夭
燿	耀
葯	药
藥	药
鑰	钥
鷂	鹞
爺	爷
釾	䥺
鋣	铘
埜	野
𡐨	野
亱	夜
叶	叶
擫	𢬍
曄	晔
業	业
燁	烨
爗	烨
謁	谒
鄴	邺
靨	靥
頁	页
饁	馌
吚	咿
禕	祎
醫	医
銥	铱
餏	饻
鷖	鹥
儀	仪
彛	彝
彜	彝
彞	彝
訑	𫍙
詒	诒
誼	谊
貽	贻
迻	移
銕	铁
頤	颐
飴	饴
㕥	以
㠯	以
礒	𥐟
艤	舣
蟻	蚁
輢	𫐎
釔	钇
顗	𫖮
齮	𬺈
䋚	䌻
䭿	𩧭
䴬	𪎈
億	亿
勩	勚
囈	呓
妷	侄
嶧	峄
憶	忆
懌	怿
異	异
瘞	瘗
瘱	𪽷
瞖	翳
縊	缢
繶	𫄷
繹	绎
義	义
藝	艺
虉	𬟁
詣	诣
譯	译
議	议
軼	轶
釴	𬬩
鈠	𨱁
鎰	镒
鐿	镱
驛	驿
鷁	鹢
囙	因
婣	姻
慇	殷
瘖	喑
絪	𬘡
緸	𦈑
蔭	荫
諲	𬤇
銦	铟
闉	𬮱
陰	阴
陻	堙
隂	阴
駰	骃
婬	淫
檭	𣘴
滛	淫
誾	訚
釿	𬬱
銀	银
鷣	𫜃
㱃	饮
䌥	𦈠
癮	瘾
紖	纼
縯	𬙂
蘟	𦻕
隠	隐
隱	隐
飲	饮
廕	荫
憖	慭
猌	𪺽
鮣	䲟
嚶	嘤
嬰	婴
孆	𫝭
孾	𪧀
應	应
攖	撄
櫻	樱
瓔	璎
甖	罂
緓	绬
纓	缨
罃	䓨
罌	罂
鍈	锳
鶯	莺
鷹	鹰
鸎	莺
鸚	鹦
塋	茔
瀅	滢
瀠	潆
熒	荧
營	营
瑩	莹
縈	萦
螢	萤
蠅	蝇
贏	赢
鎣	蓥
巊	𪩎
潁	颍
癭	瘿
穎	颖
暎	映
喲	哟
擁	拥
癰	痈
鏞	镛
雝	雍
鱅	鳙
顒	颙
惥	恿
慂	恿
詠	咏
踴	踊
鯒	鲬
醟	蒏
優	优
憂	忧
猶	犹
蕕	莸
輶	𬨎
遊	游
郵	邮
鈾	铀
魷	鱿
鮋	鲉
銪	铕
誘	诱
於	于 於
紆	纡
㦛	𢗓
䱷	䲣
余	余
娛	娱
歟	欤
漁	渔
璵	玙
籅	𥫣
緰	𦈕
覦	觎
諛	谀
踰	逾
輿	舆
餘	余
騟	𩨈
魚	鱼
俁	俣
傴	伛
嶼	屿
與	与
語	语
齬	龉
嫗	妪
庽	寓
御	御
慾	欲
欝	郁
澦	滪
獄	狱
瘉	愈
癒	愈
禦	御
蕷	蓣
諭	谕
譽	誉
軉	𨉗
郁	郁
鈺	钰
錥	𫓾
閾	阈
預	预
飫	饫
馭	驭
鬰	郁
鬱	郁
鴥	𫛣
鵒	鹆
鷸	鹬
𡨘	冤
寃	冤
淵	渊
鳶	鸢
鴛	鸳
鵷	鹓
䬧	𫗟
員	员
園	园
圓	圆
櫞	橼
猨	猿
緣	缘
蝯	猿
轅	辕
騵	𫘪
鶰	𫛫
黿	鼋
䛄	𫍠
遠	远
願	愿
𨊸	䢁
嶽	岳
悅	悦
粵	粤
躍	跃
鈅	钥
鉞	钺
閱	阅
閲	阅
鸑	𬸚
暈	晕
氳	氲
縕	缊
蒕	蒀
贇	赟
㜏	㛣
䉙	𥬀
云	云
勻	匀
榲	榅
溳	涢
澐	沄
熅	煴
熉	𤈶
篔	筼
紜	纭
芸	芸
蕓	芸
鄖	郧
雲	云
殞	殒
鈗	𫟵
隕	陨
霣	𫕥
䲰	𪉂
䵴	𫜙
惲	恽
慍	愠
緷	𦈉
腪	𣍯
薀	蕰
藴	蕴
蘊	蕴
運	运
鄆	郓
醖	酝
醞	酝
韞	韫
韻	韵
帀	匝
紮	扎
臢	臜
鉔	𫓬
偺	咱
襍	杂
雑	杂
雜	杂
鮺	鲝
災	灾
烖	灾
菑	灾
儎	傤
載	载
𠕂	再
𠕅	再
簮	簪
𠴰	咱
儧	攒
喒	咱
䟎	趱
趲	趱
暫	暂
欑	𪴙
瓉	瓒
瓚	瓒
讃	赞
讚	赞
賛	赞
贊	赞
鄼	酂
鏨	錾
贓	赃
贜	赃
鍺	锗
髒	脏
駔	驵
塟	葬
臟	脏
𦵏	葬
蹧	糟
鑿	凿
棗	枣
唕	唣
皁	皂
竈	灶
譟	噪
則	则
嘖	啧
幘	帻
擇	择
澤	泽
皟	𤾀
萴	荝
責	责
賾	赜
鰂	鲗
賊	贼
譛	谮
繒	缯
驓	𫘯
綜	综
贈	赠
鋥	锃
吒	吒 咤
謯	𫍹
劄	札 劄
牐	闸
紥	扎
鍘	铡
閘	闸
鮓	鲊
搾	榨
柵	栅
詐	诈
齋	斋
飵	𫗢
債	债
砦	寨
氈	毡
氊	毡
詀	𧮪
譫	谵
鉆	钻
霑	沾
饘	𫗴
驙	𫘰
鱣	鳣
鸇	鹯
嶃	崭
嶄	崭
斬	斩
樿	椫
琖	盏
盞	盏
輾	辗
醆	盏
颭	飐
佔	占
嶘	𡺄
戰	战
棧	栈
椾	笺
綻	绽
驏	骣
張	张
餦	𫗠
鱆	𫠒
麞	獐
漲	涨
鞝	绱
帳	帐
痮	𪽪
脹	胀
賬	账
釗	钊
鉊	𬬿
櫂	棹
炤	照
詔	诏
趙	赵
鵫	𫛱
喆	哲 喆
慴	慑
折	折
摺	折
蟄	蛰
襵	𫌇
謫	谪
讁	谪
讋	詟
輒	辄
輙	辄
鮿	𫚚
這	这
鷓	鹧
偵	侦
楨	桢
珎	珍
眞	真
碪	砧
禎	祯
診	诊
貞	贞
遉	侦
針	针
鉁	𨱅
鍼	针
䪴	𫖫
縝	缜
軫	轸
㓄	𪠟
誫	𫍨
賑	赈
鎭	镇
鎮	镇
陣	阵
鴆	鸩
崢	峥
征	征
徵	征 徵
掙	挣
爭	争
猙	狰
症	症
癥	症
睜	睁
箏	筝
諍	诤
鉦	钲
錚	铮
䦛	䦶
幀	帧
証	证
證	证
鄭	郑
巵	卮
梔	栀
秖	只
織	织
隻	只
鳷	𫛛
鴲	𪉆
執	执
姪	侄
縶	絷
聀	职
職	职
蹠	跖
躑	踯
帋	纸
紙	纸
訨	𫟞
軹	轵
㘉	𠰱
𡠹	㛿
䦯	𫔵
制	制
寘	置
幟	帜
摯	挚
擲	掷
櫍	𬃊
櫛	栉
淛	浙
滯	滞
稺	稚
緻	致
致	致
袟	帙
袠	帙
製	制
觶	觯
誌	志
質	质
贄	贽
躓	踬
輊	轾
銍	铚
鑕	锧
駤	𫘠
騭	骘
鷙	鸷
終	终
鈡	钟
鍾	钟 锺
鐘	钟
塚	冢
种	种
種	种
腫	肿
䱰	𩾋
眾	众
緟	𫟆
衆	众
諥	𫍳
謅	诌
譸	诪
賙	赒
輈	辀
輖	𫐏
週	周
銂	𫟻
鵃	鸼
軸	轴
箒	帚
鯞	𫚡
㑳	㑇
㥮	㤘
冑	胄
呪	咒
晝	昼
皺	皱
紂	纣
縐	绉
葤	荮
駎	𩧨
驟	骤
朱	朱
櫧	槠
櫫	橥
瀦	潴
硃	朱
誅	诛
諸	诸
豬	猪
銖	铢
䘚	卒
劚	㔉
斸	㔉
燭	烛
爥	𪹳
築	筑
蠾	𧑏
囑	嘱
孎	𡠟
欘	𣚚
煑	煮
眝	𪾣
矚	瞩
詝	𬣞
貯	贮
佇	伫
竚	伫
筑	筑
筯	箸
紵	纻
註	注
鑄	铸
駐	驻
塼	砖
專	专
甎	砖
磚	砖
膞	䏝
鄟	𫑘
顓	颛
鱄	𫚋
囀	啭
竱	𫁟
轉	转
籑	馔
縳	䌸
譔	撰
賺	赚
饌	馔
妝	妆
樁	桩
粧	妆
荘	庄
莊	庄
裝	装
壯	壮
狀	状
錐	锥
騅	骓
墜	坠
綴	缀
縋	缒
贅	赘
諄	谆
准	准
準	准
綧	𬘯
鐯	䦃
斮	斫
斲	斫
斵	斫
梲	棁
槕	桌
濁	浊
諑	诼
鐲	镯
鷟	𬸦
澬	𫞚
緇	缁
茲	兹
蠀	𧏗
諮	咨 谘
貲	资 赀
資	资
輜	辎
錙	锱
鎡	镃
鯔	鲻
鰦	𫚤
鴜	𪉈
鶿	鹚
齜	龇
姉	姊
釨	𫓦
漬	渍
眥	眦
椶	棕
縂	总
縱	纵
豵	𫎆
蹤	踪
騣	鬃
鬉	鬃
傯	偬
搃	总
總	总
瘲	疭
糉	粽
媰	㛀
諏	诹
鄒	邹
騶	驺
鯫	鲰
蹵	蹴
爼	俎
組	组
詛	诅
躦	躜
鑚	钻
鑽	钻
䂎	𥎝
𥲻	纂
纉	缵
纘	缵
纗	𫄹
㝡	最
辠	罪
罇	樽
鐏	𨱔
鱒	鳟
鷷	𫜄
繓	𦈛
兔	兔
奔	奔
虜	虏
尩	尪
僲	仙
蓭	庵
盫	盦
堓	岸
靌	宝
邉	边
賔	宾
飊	飙
穪	称
䖏	处
樷	丛
藂	丛
逓	递
綘	缝
㱕	归
䢜	归
諙	话
矦	侯
拠	据
㩀	据
斚	斝
麕	麇
麏	麇
兾	冀
艥	楫
肻	肯
畒	亩
畞	亩
宻	密
黙	默
蘃	蕊
歳	岁
鏁	锁
捜	搜
迯	逃
躰	体
軆	体
骵	体
蚉	蚊
虗	虚
冝	宜
宐	宜
䕃	荫
竃	灶
対	对
駞	驼
鈆	铅
値	值
紬	绸
𦜕	跽
𠤷	匜
郞	郎
璿	璇 琼
為	为
顚	颠
屛	屏
蒐	搜 蒐
鍊	炼 链 鍊
煇	辉
淸	清
𥴦	篴
豼	貔
弾	弹
𨶏	阙
頴	颖
夑	燮
繋	系
呑	吞
㓕	灭
撃	击
斾	旆
韝	鞲 韝
傌	骂
齩	咬
𤑔	爇
饟	饷
蒍	𫇭
𩣏	桀
㮄	榜
釐	厘 釐 禧
餧	喂
揅	研
髙	高
鰌	鳅
菭	苔
龝	秋
鼍	鼍
𩎢	弢
繈	襁
譾	谫
媯	妫
箚	札 劄
郰	鄹
凂	浼
𠪾	历
𥵃	盏
飮	饮
厓	崖 睚 涯 厓
糺	纠
譆	嘻
鬂	鬓
嫓	媲
愼	慎
阯	址 阯
緖	绪
尅	克
髠	髡
𠏉	干
吿	告
籖	签
逰	游
粇	糠
飈	飙
靑	青
涙	泪
𪨷	岩
勑	敕 勑
髪	发
厯	历
莭	节
濳	潜
閤	閤 阖 阁
讐	仇 雠
紏	纠
餋	养
朮	术
筴	策
訢	欣 䜣
𤍠	热
粬	曲
幷	并
飡	餐
婾	偷
楡	榆
礮	炮
挿	插
宼	寇
悮	误
𫇛	橹
閒	闲 间
瑍	𤥺
磗	砖
髩	鬓
尙	尚
躱	躲
㵎	涧
擥	揽
冦	寇
𣒣	芒
蹔	暂
偸	偷
鞾	靴
橣	柠
㫖	旨
騌	鬃
郎	郎
湌	餐
聨	联
𧅰	护
喩	喻
緪	𬘵	
瑉	珉
槪	概
夀	寿
蹻	跷 𪨗 𫏋
欍	柩
塡	填
兪	俞
鄕	乡
䒶	天
倶	俱
𦋀	罥
頺	颓
沖	冲
𠒋	凶
貟	员
甁	瓶
𣪩	杀
𥄅	昈
𨝣	鄙
𰩇	窌
豣	豜
𰷻	𧽍
𠌸	偋
𥅝	䀘
孶	孳
𥧑	窴
𠰸	咽
𧶀	𧶊
暭	暤
翶	翱
𬺠	龣
𡫞	逾
𣕹	𣓉
𬚹	𦚩
𨦃	䤪
槇	槙
腁	胼
漑	溉
姸	妍
𰹏	𨋖
寏	𡨡
𮁳	𥙨
墍	塈
𮡯	铆
筓	笄
𩟪	饡
𰙌	欭
𧊱	𧊶
𬎨	𤬾
𰧪	礸
偼	倢
輧	𫐌
𫞟	为
𢭇	摠
𧯌	䜰
𮀶	研
𢻻	启
餠	饼
𦖯	䧦
𢷽	摡
𧙊	裀
𥓁	硇
𥎞	𥎝
𡂐	囋
戸	户
𦢤	臜
𪏖	䵎
𥅳	䀘
郉	邢
𪏡	斢
𮆫	籫
𧻞	趓
𤇆	烟
𢩄	戽
𪬑	𫺬
𪡌	咨
𥔵	磁
廏	厩
𪜭	个
𠛬	刑
𥬸	𥬲
𤀀	澚
巓	巅
𦕻	聪
𭥦	昴
𨇃	躜
𢨾	戾
𡎖	埙
愌	𢚾
𠸝	喋
𬵈	𩶾
蔉	蓘
𠅙	亮
𧪌	誱
𡏲	塈
𩍴	𩎈
騈	骈
彚	汇
圎	圆
𢴀	摍
喞	唧
𧫲	谝
𫩴	哚
敻	夐
𨹃	𨹄
𥈤	睫
噑	嗥
曁	暨
帲	帡
倂	并
𬆔	𣧷
媫	婕
𡠖	𡟷
𦨼	𦨳
𮃄	𥞛
𥠺	蒀
圗	图
𢊸	廪
𥕦	磙
皡	皞
刴	剁
挅	挆
𮍧	叟
鷱	鷎
𫮰	墙
煕	熙
𦵉	萐
𦐧	羿
𦸇	𦬸
硏	研
𰡼	𤤸
𱄔	骃
詽	訮
廽	回
㛆	㛊
𥳁	𥲤
𭻐	𤱧
𦄲	缩
𭰊	洇
𮦍	𩂞
𦂟	繴
𦱍	菻
𦲬	菻
獔	獆
𥁕	昷
𰱵	蓿
痲	麻
逬	迸
𪇔	鹚